Symbol,Exchange,Currency,Trades Found,Take Profit,Profit,StopLoss,Loss,Wins,%
DE,SMART,USD,8,0,8,0,0,8,100
NWS,SMART,USD,6,1,5,0,0,6,100
RPM,SMART,USD,6,0,6,0,0,6,100
LMND,SMART,USD,5,5,0,0,0,5,100
ALSN,SMART,USD,4,2,2,0,0,4,100
TDY,SMART,USD,4,1,3,0,0,4,100
BEPC,SMART,USD,4,1,3,0,0,4,100
ICUI,SMART,USD,4,0,4,0,0,4,100
OMC,SMART,USD,4,0,4,0,0,4,100
ODFL,SMART,USD,4,0,4,0,0,4,100
TXRH,SMART,USD,11,2,8,1,0,10,90.91
ENS,SMART,USD,10,1,8,0,1,9,90
STZ,SMART,USD,9,1,7,1,0,8,88.89
GIL,SMART,USD,8,4,3,1,0,7,87.5
CPA,SMART,USD,8,0,7,1,0,7,87.5
CLH,SMART,USD,7,3,3,0,1,6,85.71
SC,SMART,USD,7,3,3,1,0,6,85.71
CMCSA,SMART,USD,7,2,4,1,0,6,85.71
EL,SMART,USD,7,1,5,1,0,6,85.71
PRAH,SMART,USD,7,1,5,1,0,6,85.71
BLD,SMART,USD,7,0,6,1,0,6,85.71
ROG,SMART,USD,13,2,9,1,1,11,84.62
VAC,SMART,USD,12,3,7,0,2,10,83.33
LBTYB,SMART,USD,12,2,8,0,2,10,83.33
NEP,SMART,USD,6,2,3,0,1,5,83.33
IPG,SMART,USD,6,2,3,1,0,5,83.33
IDXX,SMART,USD,6,2,3,1,0,5,83.33
HLI,SMART,USD,6,1,4,0,1,5,83.33
BCPC,SMART,USD,6,1,4,0,1,5,83.33
MTD,SMART,USD,6,1,4,0,1,5,83.33
WF,SMART,USD,6,1,4,0,1,5,83.33
CHH,SMART,USD,6,1,4,1,0,5,83.33
IT,SMART,USD,6,0,5,0,1,5,83.33
DIS,SMART,USD,6,0,5,1,0,5,83.33
UI,SMART,USD,6,0,5,1,0,5,83.33
IEP,SMART,USD,11,2,7,2,0,9,81.82
KMT,SMART,USD,11,1,8,1,1,9,81.82
SUZ,SMART,USD,11,0,9,0,2,9,81.82
ITGR,SMART,USD,10,2,6,1,1,8,80
BNTX,SMART,USD,5,4,0,1,0,4,80
TOT,SMART,USD,5,2,2,1,0,4,80
TKC,SMART,USD,5,1,3,0,1,4,80
CABO,SMART,USD,5,1,3,0,1,4,80
LEA,SMART,USD,5,1,3,0,1,4,80
MCY,SMART,USD,5,1,3,1,0,4,80
ORLY,SMART,USD,5,1,3,1,0,4,80
LBRDA,SMART,USD,5,1,3,1,0,4,80
SCHW,SMART,USD,5,0,4,0,1,4,80
STT,SMART,USD,5,0,4,0,1,4,80
NDSN,SMART,USD,5,0,4,0,1,4,80
BKI,SMART,USD,5,0,4,0,1,4,80
ERIE,SMART,USD,5,0,4,0,1,4,80
MAN,SMART,USD,5,0,4,1,0,4,80
FNB,SMART,USD,5,0,4,1,0,4,80
SEIC,SMART,USD,5,0,4,1,0,4,80
IQV,SMART,USD,5,0,4,1,0,4,80
CIB,SMART,USD,14,3,8,2,1,11,78.57
HGV,SMART,USD,9,3,4,0,2,7,77.78
RXN,SMART,USD,9,3,4,1,1,7,77.78
HP,SMART,USD,9,3,4,2,0,7,77.78
ZBRA,SMART,USD,9,2,5,0,2,7,77.78
LYB,SMART,USD,9,2,5,2,0,7,77.78
AAP,SMART,USD,9,2,5,2,0,7,77.78
LOGI,SMART,USD,9,1,6,0,2,7,77.78
CIXX,SMART,USD,9,1,6,1,1,7,77.78
HOLX,SMART,USD,9,1,6,1,1,7,77.78
APH,SMART,USD,9,1,6,1,1,7,77.78
ABBV,SMART,USD,9,0,7,0,2,7,77.78
FUBO,SMART,USD,16,8,4,4,0,12,75
NUS,SMART,USD,16,2,10,3,1,12,75
NRG,SMART,USD,12,1,8,2,1,9,75
LYV,SMART,USD,8,4,2,0,2,6,75
PYPL,SMART,USD,8,2,4,2,0,6,75
RGEN,SMART,USD,8,2,4,2,0,6,75
SSNC,SMART,USD,8,2,4,2,0,6,75
IX,SMART,USD,8,1,5,0,2,6,75
VFC,SMART,USD,8,1,5,1,1,6,75
TAC,SMART,USD,8,1,5,1,1,6,75
NWSA,SMART,USD,8,1,5,1,1,6,75
AJRD,SMART,USD,8,1,5,1,1,6,75
RBA,SMART,USD,8,1,5,1,1,6,75
DHI,SMART,USD,8,1,5,1,1,6,75
ARD,SMART,USD,8,1,5,1,1,6,75
NCNO,SMART,USD,4,3,0,1,0,3,75
BG,SMART,USD,4,2,1,0,1,3,75
LEGN,SMART,USD,4,2,1,1,0,3,75
AMWL,SMART,USD,4,2,1,1,0,3,75
TRI,SMART,USD,4,1,2,0,1,3,75
TIGO,SMART,USD,4,1,2,0,1,3,75
RELX,SMART,USD,4,1,2,0,1,3,75
TEL,SMART,USD,4,1,2,1,0,3,75
ONB,SMART,USD,4,1,2,1,0,3,75
MUFG,SMART,USD,4,1,2,1,0,3,75
LW,SMART,USD,4,1,2,1,0,3,75
CBRL,SMART,USD,4,1,2,1,0,3,75
AZO,SMART,USD,4,1,2,1,0,3,75
TTEK,SMART,USD,4,1,2,1,0,3,75
TD,SMART,USD,4,1,2,1,0,3,75
FB,SMART,USD,4,1,2,1,0,3,75
LEVI,SMART,USD,4,1,2,1,0,3,75
ADI,SMART,USD,4,0,3,0,1,3,75
ASML,SMART,USD,4,0,3,0,1,3,75
ROL,SMART,USD,4,0,3,0,1,3,75
NEU,SMART,USD,4,0,3,0,1,3,75
JEF,SMART,USD,4,0,3,1,0,3,75
MSI,SMART,USD,4,0,3,1,0,3,75
LSTR,SMART,USD,4,0,3,1,0,3,75
POST,SMART,USD,4,0,3,1,0,3,75
V,SMART,USD,4,0,3,1,0,3,75
ALGN,SMART,USD,11,4,4,1,2,8,72.73
BBDO,SMART,USD,11,3,5,1,2,8,72.73
LTRPB,SMART,USD,11,2,6,2,1,8,72.73
NVMI,SMART,USD,11,2,6,3,0,8,72.73
CIGI,SMART,USD,11,1,7,2,1,8,72.73
MMYT,SMART,USD,14,4,6,4,0,10,71.43
WK,SMART,USD,14,2,8,4,0,10,71.43
AYI,SMART,USD,14,1,9,2,2,10,71.43
MSTR,SMART,USD,7,3,2,1,1,5,71.43
MSCI,SMART,USD,7,2,3,0,2,5,71.43
KMPR,SMART,USD,7,2,3,0,2,5,71.43
DOW,SMART,USD,7,2,3,1,1,5,71.43
TRTN,SMART,USD,7,2,3,2,0,5,71.43
ZNGA,SMART,USD,7,2,3,2,0,5,71.43
SWI,SMART,USD,7,2,3,2,0,5,71.43
PCAR,SMART,USD,7,1,4,1,1,5,71.43
MCK,SMART,USD,7,1,4,1,1,5,71.43
SU,SMART,USD,7,1,4,1,1,5,71.43
FSV,SMART,USD,7,1,4,1,1,5,71.43
GPC,SMART,USD,7,1,4,1,1,5,71.43
ARW,SMART,USD,7,1,4,1,1,5,71.43
LPL,SMART,USD,7,0,5,0,2,5,71.43
VSAT,SMART,USD,7,0,5,0,2,5,71.43
LDOS,SMART,USD,7,0,5,0,2,5,71.43
FCFS,SMART,USD,7,0,5,0,2,5,71.43
UBS,SMART,USD,7,0,5,1,1,5,71.43
CBT,SMART,USD,10,3,4,2,1,7,70
SIRI,SMART,USD,10,2,5,2,1,7,70
PACW,SMART,USD,10,2,5,2,1,7,70
KEP,SMART,USD,10,1,6,0,3,7,70
CWEN,SMART,USD,10,1,6,2,1,7,70
HPQ,SMART,USD,10,0,7,1,2,7,70
CTB,SMART,USD,10,0,7,1,2,7,70
PSXP,SMART,USD,13,2,7,2,2,9,69.23
OLLI,SMART,USD,13,0,9,4,0,9,69.23
COTY,SMART,USD,16,5,6,4,1,11,68.75
DISCB,SMART,USD,21,1,13,4,3,14,66.67
ZNH,SMART,USD,18,1,11,2,4,12,66.67
ZEN,SMART,USD,15,3,7,3,2,10,66.67
BIDU,SMART,USD,15,3,7,4,1,10,66.67
LOB,SMART,USD,15,2,8,4,1,10,66.67
SSTK,SMART,USD,15,1,9,1,4,10,66.67
VIRT,SMART,USD,12,3,5,2,2,8,66.67
CX,SMART,USD,12,3,5,3,1,8,66.67
TEX,SMART,USD,12,2,6,3,1,8,66.67
TRN,SMART,USD,12,1,7,2,2,8,66.67
SONO,SMART,USD,9,3,3,2,1,6,66.67
SUM,SMART,USD,9,3,3,3,0,6,66.67
CRWD,SMART,USD,9,3,3,3,0,6,66.67
CBRE,SMART,USD,9,2,4,1,2,6,66.67
IP,SMART,USD,9,2,4,2,1,6,66.67
SPGI,SMART,USD,9,2,4,2,1,6,66.67
HWC,SMART,USD,9,2,4,2,1,6,66.67
ATHM,SMART,USD,9,2,4,3,0,6,66.67
AIT,SMART,USD,9,1,5,1,2,6,66.67
SQM,SMART,USD,9,1,5,3,0,6,66.67
BKU,SMART,USD,9,1,5,3,0,6,66.67
ORA,SMART,USD,9,1,5,3,0,6,66.67
BBVA,SMART,USD,9,0,6,1,2,6,66.67
XLNX,SMART,USD,9,0,6,1,2,6,66.67
LYG,SMART,USD,9,0,6,2,1,6,66.67
INDB,SMART,USD,9,0,6,2,1,6,66.67
BEP,SMART,USD,9,0,6,2,1,6,66.67
NCR,SMART,USD,9,0,6,3,0,6,66.67
TDC,SMART,USD,9,0,6,3,0,6,66.67
ABG,SMART,USD,9,0,6,3,0,6,66.67
NNI,SMART,USD,6,2,2,1,1,4,66.67
APAM,SMART,USD,6,2,2,1,1,4,66.67
HAIN,SMART,USD,6,2,2,1,1,4,66.67
BAH,SMART,USD,6,2,2,1,1,4,66.67
AMX,SMART,USD,6,2,2,2,0,4,66.67
EYE,SMART,USD,6,2,2,2,0,4,66.67
MAS,SMART,USD,6,1,3,0,2,4,66.67
PPG,SMART,USD,6,1,3,0,2,4,66.67
SKM,SMART,USD,6,1,3,0,2,4,66.67
DAR,SMART,USD,6,1,3,1,1,4,66.67
AIG,SMART,USD,6,1,3,1,1,4,66.67
GPN,SMART,USD,6,1,3,1,1,4,66.67
GLW,SMART,USD,6,1,3,1,1,4,66.67
MKC,SMART,USD,6,1,3,1,1,4,66.67
DRI,SMART,USD,6,1,3,1,1,4,66.67
MET,SMART,USD,6,1,3,2,0,4,66.67
UCBI,SMART,USD,6,1,3,2,0,4,66.67
CATY,SMART,USD,6,1,3,2,0,4,66.67
RGA,SMART,USD,6,1,3,2,0,4,66.67
UMPQ,SMART,USD,6,0,4,0,2,4,66.67
CAH,SMART,USD,6,0,4,0,2,4,66.67
DGX,SMART,USD,6,0,4,0,2,4,66.67
SBNY,SMART,USD,6,0,4,1,1,4,66.67
CNI,SMART,USD,6,0,4,1,1,4,66.67
IBOC,SMART,USD,6,0,4,1,1,4,66.67
SFNC,SMART,USD,6,0,4,1,1,4,66.67
WU,SMART,USD,6,0,4,1,1,4,66.67
TER,SMART,USD,6,0,4,2,0,4,66.67
SMFG,SMART,USD,6,0,4,2,0,4,66.67
AVLR,SMART,USD,6,0,4,2,0,4,66.67
CVE,SMART,USD,20,5,8,4,3,13,65
QRTEB,SMART,USD,17,0,11,5,1,11,64.71
AQUA,SMART,USD,14,4,5,2,3,9,64.29
CPRI,SMART,USD,14,4,5,5,0,9,64.29
POWI,SMART,USD,14,3,6,3,2,9,64.29
ACHC,SMART,USD,14,3,6,4,1,9,64.29
HFC,SMART,USD,14,2,7,5,0,9,64.29
SGEN,SMART,USD,14,1,8,3,2,9,64.29
ALB,SMART,USD,11,3,4,2,2,7,63.64
SHLX,SMART,USD,11,3,4,3,1,7,63.64
ASR,SMART,USD,11,3,4,3,1,7,63.64
WCC,SMART,USD,11,2,5,2,2,7,63.64
PEN,SMART,USD,11,2,5,3,1,7,63.64
MU,SMART,USD,11,1,6,2,2,7,63.64
ESI,SMART,USD,11,1,6,2,2,7,63.64
SPSC,SMART,USD,11,1,6,2,2,7,63.64
CF,SMART,USD,11,1,6,3,1,7,63.64
HII,SMART,USD,11,0,7,2,2,7,63.64
ALTR,SMART,USD,11,0,7,2,2,7,63.64
TX,SMART,USD,19,2,10,2,5,12,63.16
IIVI,SMART,USD,16,5,5,5,1,10,62.5
HCM,SMART,USD,16,5,5,6,0,10,62.5
LTHM,SMART,USD,8,4,1,1,2,5,62.5
AMN,SMART,USD,8,3,2,2,1,5,62.5
TENB,SMART,USD,8,3,2,2,1,5,62.5
KTB,SMART,USD,8,3,2,2,1,5,62.5
DCPH,SMART,USD,8,3,2,3,0,5,62.5
ANSS,SMART,USD,8,2,3,2,1,5,62.5
UHS,SMART,USD,8,2,3,2,1,5,62.5
URBN,SMART,USD,8,2,3,2,1,5,62.5
AZPN,SMART,USD,8,2,3,2,1,5,62.5
FCNCA,SMART,USD,8,2,3,2,1,5,62.5
EGHT,SMART,USD,8,2,3,3,0,5,62.5
ENV,SMART,USD,8,2,3,3,0,5,62.5
FOXA,SMART,USD,8,2,3,3,0,5,62.5
HI,SMART,USD,8,1,4,0,3,5,62.5
VMW,SMART,USD,8,1,4,0,3,5,62.5
DFS,SMART,USD,8,1,4,1,2,5,62.5
MORN,SMART,USD,8,1,4,1,2,5,62.5
KNX,SMART,USD,8,1,4,1,2,5,62.5
CHRW,SMART,USD,8,1,4,1,2,5,62.5
BEN,SMART,USD,8,1,4,2,1,5,62.5
ANTM,SMART,USD,8,1,4,2,1,5,62.5
OC,SMART,USD,8,1,4,2,1,5,62.5
SXT,SMART,USD,8,1,4,2,1,5,62.5
ISRG,SMART,USD,8,1,4,2,1,5,62.5
KSU,SMART,USD,8,1,4,2,1,5,62.5
PB,SMART,USD,8,1,4,3,0,5,62.5
SLB,SMART,USD,8,1,4,3,0,5,62.5
TS,SMART,USD,8,0,5,0,3,5,62.5
MO,SMART,USD,8,0,5,0,3,5,62.5
SAN,SMART,USD,8,0,5,1,2,5,62.5
REGN,SMART,USD,8,0,5,2,1,5,62.5
AXTA,SMART,USD,8,0,5,2,1,5,62.5
CE,SMART,USD,8,0,5,2,1,5,62.5
WNS,SMART,USD,8,0,5,2,1,5,62.5
K,SMART,USD,8,0,5,2,1,5,62.5
FTV,SMART,USD,8,0,5,2,1,5,62.5
IR,SMART,USD,8,0,5,2,1,5,62.5
FHN,SMART,USD,8,0,5,3,0,5,62.5
VLY,SMART,USD,8,0,5,3,0,5,62.5
INSP,SMART,USD,13,5,3,5,0,8,61.54
MXL,SMART,USD,13,3,5,5,0,8,61.54
AER,SMART,USD,13,2,6,2,3,8,61.54
NOV,SMART,USD,13,2,6,4,1,8,61.54
DISCK,SMART,USD,13,2,6,4,1,8,61.54
FLEX,SMART,USD,13,2,6,4,1,8,61.54
WAB,SMART,USD,13,1,7,2,3,8,61.54
SNX,SMART,USD,13,1,7,2,3,8,61.54
OXY,SMART,USD,13,1,7,4,1,8,61.54
THO,SMART,USD,13,0,8,4,1,8,61.54
MPC,SMART,USD,13,0,8,4,1,8,61.54
M,SMART,USD,18,5,6,4,3,11,61.11
Z,SMART,USD,18,5,6,5,2,11,61.11
TDOC,SMART,USD,15,6,3,6,0,9,60
PAA,SMART,USD,15,2,7,6,0,9,60
MRNA,SMART,USD,10,5,1,4,0,6,60
BKNG,SMART,USD,10,3,3,2,2,6,60
DOOR,SMART,USD,10,3,3,2,2,6,60
UMC,SMART,USD,10,3,3,2,2,6,60
BTG,SMART,USD,10,3,3,3,1,6,60
CMD,SMART,USD,10,3,3,3,1,6,60
DAVA,SMART,USD,10,3,3,3,1,6,60
LILA,SMART,USD,10,2,4,0,4,6,60
WMB,SMART,USD,10,2,4,2,2,6,60
AGI,SMART,USD,10,2,4,3,1,6,60
PAAS,SMART,USD,10,2,4,3,1,6,60
IRDM,SMART,USD,10,2,4,3,1,6,60
XPO,SMART,USD,10,2,4,4,0,6,60
ABC,SMART,USD,10,1,5,2,2,6,60
AL,SMART,USD,10,1,5,2,2,6,60
CNS,SMART,USD,10,1,5,3,1,6,60
TRUP,SMART,USD,10,1,5,4,0,6,60
RHI,SMART,USD,10,0,6,1,3,6,60
STLA,SMART,USD,10,0,6,1,3,6,60
SFM,SMART,USD,10,0,6,4,0,6,60
ALRM,SMART,USD,10,0,6,4,0,6,60
BILL,SMART,USD,5,3,0,2,0,3,60
NARI,SMART,USD,5,3,0,2,0,3,60
CHPT,SMART,USD,5,3,0,2,0,3,60
ASH,SMART,USD,5,2,1,1,1,3,60
NVR,SMART,USD,5,2,1,2,0,3,60
GPK,SMART,USD,5,2,1,2,0,3,60
PHG,SMART,USD,5,1,2,0,2,3,60
INFY,SMART,USD,5,1,2,0,2,3,60
EXP,SMART,USD,5,1,2,0,2,3,60
ENTG,SMART,USD,5,1,2,0,2,3,60
NDAQ,SMART,USD,5,1,2,0,2,3,60
GLL,SMART,USD,5,1,2,0,2,3,60
LBTYK,SMART,USD,5,1,2,1,1,3,60
INFO,SMART,USD,5,1,2,1,1,3,60
MFG,SMART,USD,5,1,2,1,1,3,60
PFGC,SMART,USD,5,1,2,1,1,3,60
PSX,SMART,USD,5,1,2,1,1,3,60
CHDN,SMART,USD,5,1,2,1,1,3,60
BXP,SMART,USD,5,1,2,1,1,3,60
HUN,SMART,USD,5,1,2,2,0,3,60
EFX,SMART,USD,5,1,2,2,0,3,60
TXN,SMART,USD,5,0,3,0,2,3,60
NVS,SMART,USD,5,0,3,0,2,3,60
BUD,SMART,USD,5,0,3,0,2,3,60
SNP,SMART,USD,5,0,3,0,2,3,60
WFC,SMART,USD,5,0,3,1,1,3,60
NTAP,SMART,USD,5,0,3,1,1,3,60
ZBH,SMART,USD,5,0,3,1,1,3,60
ABEV,SMART,USD,5,0,3,1,1,3,60
BXS,SMART,USD,5,0,3,1,1,3,60
TAK,SMART,USD,5,0,3,1,1,3,60
JKHY,SMART,USD,5,0,3,1,1,3,60
SIGI,SMART,USD,5,0,3,2,0,3,60
MTX,SMART,USD,5,0,3,2,0,3,60
QCOM,SMART,USD,5,0,3,2,0,3,60
TFX,SMART,USD,5,0,3,2,0,3,60
USM,SMART,USD,5,0,3,2,0,3,60
NYCB,SMART,USD,5,0,3,2,0,3,60
AWR,SMART,USD,5,0,3,2,0,3,60
SPWR,SMART,USD,22,8,5,8,1,13,59.09
CHGG,SMART,USD,17,5,5,5,2,10,58.82
RCII,SMART,USD,17,3,7,4,3,10,58.82
MLCO,SMART,USD,17,2,8,2,5,10,58.82
GTLS,SMART,USD,17,1,9,4,3,10,58.82
MIME,SMART,USD,12,5,2,3,2,7,58.33
FUN,SMART,USD,12,4,3,1,4,7,58.33
SYNA,SMART,USD,12,4,3,3,2,7,58.33
CUK,SMART,USD,12,3,4,2,3,7,58.33
R,SMART,USD,12,3,4,3,2,7,58.33
EXAS,SMART,USD,12,3,4,4,1,7,58.33
BHVN,SMART,USD,12,3,4,4,1,7,58.33
SPR,SMART,USD,12,3,4,4,1,7,58.33
AM,SMART,USD,12,3,4,5,0,7,58.33
LILAK,SMART,USD,12,2,5,2,3,7,58.33
ENSG,SMART,USD,12,2,5,4,1,7,58.33
TV,SMART,USD,12,1,6,2,3,7,58.33
CRUS,SMART,USD,12,1,6,3,2,7,58.33
MEDP,SMART,USD,12,1,6,3,2,7,58.33
BSMX,SMART,USD,12,1,6,4,1,7,58.33
HLNE,SMART,USD,12,1,6,4,1,7,58.33
MT,SMART,USD,12,0,7,2,3,7,58.33
CCL,SMART,USD,14,4,4,3,3,8,57.14
SKX,SMART,USD,14,4,4,3,3,8,57.14
HRI,SMART,USD,14,3,5,3,3,8,57.14
FLOW,SMART,USD,14,2,6,4,2,8,57.14
AVAV,SMART,USD,14,2,6,4,2,8,57.14
AA,SMART,USD,14,2,6,4,2,8,57.14
ATKR,SMART,USD,14,2,6,6,0,8,57.14
MMS,SMART,USD,7,3,1,1,2,4,57.14
CR,SMART,USD,7,3,1,1,2,4,57.14
GH,SMART,USD,7,3,1,2,1,4,57.14
TPTX,SMART,USD,7,3,1,2,1,4,57.14
TME,SMART,USD,7,3,1,2,1,4,57.14
KOD,SMART,USD,7,3,1,3,0,4,57.14
PRU,SMART,USD,7,2,2,1,2,4,57.14
STM,SMART,USD,7,2,2,1,2,4,57.14
CRI,SMART,USD,7,2,2,1,2,4,57.14
SAIA,SMART,USD,7,2,2,2,1,4,57.14
PANW,SMART,USD,7,1,3,0,3,4,57.14
BERY,SMART,USD,7,1,3,1,2,4,57.14
DSGX,SMART,USD,7,1,3,1,2,4,57.14
NATI,SMART,USD,7,1,3,1,2,4,57.14
SAM,SMART,USD,7,1,3,1,2,4,57.14
CVS,SMART,USD,7,1,3,1,2,4,57.14
TFII,SMART,USD,7,1,3,1,2,4,57.14
CNNE,SMART,USD,7,1,3,2,1,4,57.14
TCF,SMART,USD,7,1,3,2,1,4,57.14
HXL,SMART,USD,7,1,3,2,1,4,57.14
BLL,SMART,USD,7,1,3,2,1,4,57.14
RCL,SMART,USD,7,1,3,3,0,4,57.14
ONEM,SMART,USD,7,1,3,3,0,4,57.14
MSA,SMART,USD,7,0,4,0,3,4,57.14
ADM,SMART,USD,7,0,4,0,3,4,57.14
BMRN,SMART,USD,7,0,4,0,3,4,57.14
TEF,SMART,USD,7,0,4,1,2,4,57.14
EWBC,SMART,USD,7,0,4,1,2,4,57.14
ADSK,SMART,USD,7,0,4,1,2,4,57.14
JHX,SMART,USD,7,0,4,2,1,4,57.14
SYF,SMART,USD,7,0,4,2,1,4,57.14
ENIC,SMART,USD,7,0,4,2,1,4,57.14
DORM,SMART,USD,7,0,4,2,1,4,57.14
RJF,SMART,USD,7,0,4,2,1,4,57.14
MRVL,SMART,USD,7,0,4,3,0,4,57.14
SAFM,SMART,USD,7,0,4,3,0,4,57.14
TWTR,SMART,USD,16,1,8,6,1,9,56.25
CRSP,SMART,USD,18,7,3,8,0,10,55.56
DOCU,SMART,USD,9,5,0,3,1,5,55.56
CHNG,SMART,USD,9,5,0,3,1,5,55.56
CNX,SMART,USD,9,4,1,4,0,5,55.56
FSLY,SMART,USD,9,4,1,4,0,5,55.56
PTC,SMART,USD,9,3,2,1,3,5,55.56
HZNP,SMART,USD,9,3,2,3,1,5,55.56
AMED,SMART,USD,9,3,2,3,1,5,55.56
DNLI,SMART,USD,9,3,2,3,1,5,55.56
FVRR,SMART,USD,9,3,2,4,0,5,55.56
NOK,SMART,USD,9,2,3,1,3,5,55.56
MBT,SMART,USD,9,2,3,2,2,5,55.56
PWR,SMART,USD,9,2,3,2,2,5,55.56
MIC,SMART,USD,9,2,3,2,2,5,55.56
CFX,SMART,USD,9,2,3,3,1,5,55.56
CROX,SMART,USD,9,2,3,3,1,5,55.56
GTES,SMART,USD,9,2,3,3,1,5,55.56
MGM,SMART,USD,9,2,3,4,0,5,55.56
LPX,SMART,USD,9,2,3,4,0,5,55.56
MTCH,SMART,USD,9,2,3,4,0,5,55.56
HUM,SMART,USD,9,1,4,0,4,5,55.56
APTV,SMART,USD,9,1,4,2,2,5,55.56
AEL,SMART,USD,9,1,4,2,2,5,55.56
SF,SMART,USD,9,1,4,2,2,5,55.56
PRI,SMART,USD,9,1,4,2,2,5,55.56
WAL,SMART,USD,9,1,4,3,1,5,55.56
VRNS,SMART,USD,9,1,4,3,1,5,55.56
LOPE,SMART,USD,9,1,4,3,1,5,55.56
VG,SMART,USD,9,1,4,3,1,5,55.56
BURL,SMART,USD,9,1,4,3,1,5,55.56
CIT,SMART,USD,9,1,4,3,1,5,55.56
SYY,SMART,USD,9,1,4,3,1,5,55.56
DISH,SMART,USD,9,1,4,3,1,5,55.56
KEX,SMART,USD,9,1,4,4,0,5,55.56
MANH,SMART,USD,9,0,5,0,4,5,55.56
PH,SMART,USD,9,0,5,2,2,5,55.56
HAS,SMART,USD,9,0,5,2,2,5,55.56
KMX,SMART,USD,9,0,5,3,1,5,55.56
NYT,SMART,USD,9,0,5,3,1,5,55.56
EPD,SMART,USD,9,0,5,4,0,5,55.56
EVTC,SMART,USD,9,0,5,4,0,5,55.56
CNHI,SMART,USD,11,3,3,0,5,6,54.55
GM,SMART,USD,11,2,4,2,3,6,54.55
CREE,SMART,USD,11,2,4,3,2,6,54.55
SMPL,SMART,USD,11,2,4,3,2,6,54.55
KL,SMART,USD,11,2,4,4,1,6,54.55
TWOU,SMART,USD,11,2,4,4,1,6,54.55
KSS,SMART,USD,11,2,4,4,1,6,54.55
TDG,SMART,USD,11,2,4,5,0,6,54.55
BIIB,SMART,USD,11,1,5,3,2,6,54.55
VEDL,SMART,USD,11,1,5,3,2,6,54.55
SUN,SMART,USD,11,0,6,3,2,6,54.55
FN,SMART,USD,11,0,6,3,2,6,54.55
INCY,SMART,USD,11,0,6,4,1,6,54.55
SEM,SMART,USD,11,0,6,4,1,6,54.55
WBS,SMART,USD,11,0,6,4,1,6,54.55
VOYA,SMART,USD,11,0,6,4,1,6,54.55
KGC,SMART,USD,11,0,6,5,0,6,54.55
ADS,SMART,USD,13,5,2,5,1,7,53.85
PRLB,SMART,USD,13,4,3,5,1,7,53.85
ETRN,SMART,USD,13,4,3,5,1,7,53.85
WFG,SMART,USD,13,3,4,2,4,7,53.85
PVH,SMART,USD,13,3,4,3,3,7,53.85
CSOD,SMART,USD,13,3,4,3,3,7,53.85
VIAC,SMART,USD,13,3,4,5,1,7,53.85
SAGE,SMART,USD,13,3,4,6,0,7,53.85
TNL,SMART,USD,13,2,5,3,3,7,53.85
EOG,SMART,USD,13,2,5,3,3,7,53.85
CLGX,SMART,USD,13,2,5,4,2,7,53.85
RPD,SMART,USD,13,2,5,4,2,7,53.85
GPS,SMART,USD,13,2,5,4,2,7,53.85
SANM,SMART,USD,13,2,5,4,2,7,53.85
SEAS,SMART,USD,13,2,5,5,1,7,53.85
AKAM,SMART,USD,13,1,6,2,4,7,53.85
BLMN,SMART,USD,13,1,6,3,3,7,53.85
FL,SMART,USD,13,1,6,4,2,7,53.85
STX,SMART,USD,13,1,6,4,2,7,53.85
AEG,SMART,USD,13,0,7,1,5,7,53.85
NVRO,SMART,USD,15,3,5,2,5,8,53.33
TROX,SMART,USD,15,2,6,7,0,8,53.33
CAR,SMART,USD,17,3,6,7,1,9,52.94
BHC,SMART,USD,17,3,6,7,1,9,52.94
OMCL,SMART,USD,17,2,7,3,5,9,52.94
PDCE,SMART,USD,17,2,7,6,2,9,52.94
ATRC,SMART,USD,17,2,7,7,1,9,52.94
TTM,SMART,USD,17,1,8,4,4,9,52.94
IRBT,SMART,USD,19,4,6,7,2,10,52.63
MAXR,SMART,USD,21,8,3,8,2,11,52.38
PAYS,SMART,USD,21,8,3,10,0,11,52.38
LI,SMART,USD,3,3,0,0,0,3,100
PPD,SMART,USD,3,2,1,0,0,3,100
PNC,SMART,USD,3,1,2,0,0,3,100
EXPD,SMART,USD,3,1,2,0,0,3,100
NTRS,SMART,USD,3,0,3,0,0,3,100
WBK,SMART,USD,3,0,3,0,0,3,100
ASX,SMART,USD,3,0,3,0,0,3,100
KC,SMART,USD,3,2,0,1,0,2,66.67
VERX,SMART,USD,3,2,0,1,0,2,66.67
API,SMART,USD,3,2,0,1,0,2,66.67
YUMC,SMART,USD,3,1,1,0,1,2,66.67
NGG,SMART,USD,3,1,1,0,1,2,66.67
CM,SMART,USD,3,1,1,0,1,2,66.67
BCE,SMART,USD,3,1,1,0,1,2,66.67
BAX,SMART,USD,3,1,1,1,0,2,66.67
TROW,SMART,USD,3,1,1,1,0,2,66.67
RSG,SMART,USD,3,1,1,1,0,2,66.67
CAG,SMART,USD,3,1,1,1,0,2,66.67
GOOGL,SMART,USD,3,1,1,1,0,2,66.67
GOOG,SMART,USD,3,1,1,1,0,2,66.67
SWTX,SMART,USD,3,1,1,1,0,2,66.67
CDNS,SMART,USD,3,1,1,1,0,2,66.67
BIP,SMART,USD,3,1,1,1,0,2,66.67
DUK,SMART,USD,3,1,1,1,0,2,66.67
GSK,SMART,USD,3,1,1,1,0,2,66.67
RKT,SMART,USD,3,1,1,1,0,2,66.67
AI,SMART,USD,3,1,1,1,0,2,66.67
ERIC,SMART,USD,3,0,2,0,1,2,66.67
FIBK,SMART,USD,3,0,2,0,1,2,66.67
LH,SMART,USD,3,0,2,0,1,2,66.67
ESLT,SMART,USD,3,0,2,0,1,2,66.67
SSD,SMART,USD,3,0,2,0,1,2,66.67
BR,SMART,USD,3,0,2,0,1,2,66.67
SEB,SMART,USD,3,0,2,0,1,2,66.67
CRL,SMART,USD,3,0,2,1,0,2,66.67
PAG,SMART,USD,3,0,2,1,0,2,66.67
DG,SMART,USD,3,0,2,1,0,2,66.67
LOW,SMART,USD,3,0,2,1,0,2,66.67
ESE,SMART,USD,3,0,2,1,0,2,66.67
AXS,SMART,USD,3,0,2,1,0,2,66.67
ISBC,SMART,USD,3,0,2,1,0,2,66.67
IEX,SMART,USD,3,0,2,1,0,2,66.67
WM,SMART,USD,3,0,2,1,0,2,66.67
ORI,SMART,USD,3,0,2,1,0,2,66.67
WSO,SMART,USD,3,0,2,1,0,2,66.67
WMT,SMART,USD,3,0,2,1,0,2,66.67
CTVA,SMART,USD,3,0,2,1,0,2,66.67
A,SMART,USD,3,0,2,1,0,2,66.67
AEP,SMART,USD,3,0,2,1,0,2,66.67
ORAN,SMART,USD,3,0,2,1,0,2,66.67
PKI,SMART,USD,3,0,2,1,0,2,66.67
FSKR,SMART,USD,2,2,0,0,0,2,100
OSCR,SMART,USD,2,2,0,0,0,2,100
SLF,SMART,USD,2,1,1,0,0,2,100
XEL,SMART,USD,2,1,1,0,0,2,100
GIS,SMART,USD,2,1,1,0,0,2,100
STN,SMART,USD,2,1,1,0,0,2,100
BIPC,SMART,USD,2,1,1,0,0,2,100
STEP,SMART,USD,2,1,1,0,0,2,100
MNSO,SMART,USD,2,1,1,0,0,2,100
KNBE,SMART,USD,2,1,1,0,0,2,100
ICE,SMART,USD,2,0,2,0,0,2,100
FELE,SMART,USD,2,0,2,0,0,2,100
BKH,SMART,USD,2,0,2,0,0,2,100
SNY,SMART,USD,2,0,2,0,0,2,100
CCU,SMART,USD,2,0,2,0,0,2,100
ECL,SMART,USD,2,0,2,0,0,2,100
AMCR,SMART,USD,2,0,2,0,0,2,100
TU,SMART,USD,2,0,2,0,0,2,100
HON,SMART,USD,2,0,2,0,0,2,100
PRG,SMART,USD,2,0,2,0,0,2,100
XP,SMART,USD,1,1,0,0,0,1,100
AQN,SMART,USD,1,1,0,0,0,1,100
CHD,SMART,USD,1,1,0,0,0,1,100
KO,SMART,USD,1,1,0,0,0,1,100
GL,SMART,USD,1,1,0,0,0,1,100
OSH,SMART,USD,1,1,0,0,0,1,100
ASAN,SMART,USD,1,1,0,0,0,1,100
MSP,SMART,USD,1,1,0,0,0,1,100
DNB,SMART,USD,1,1,0,0,0,1,100
BSY,SMART,USD,1,1,0,0,0,1,100
AFRM,SMART,USD,1,1,0,0,0,1,100
OLK,SMART,USD,1,1,0,0,0,1,100
APP,SMART,USD,1,1,0,0,0,1,100
ZY,SMART,USD,1,1,0,0,0,1,100
ALKT,SMART,USD,1,1,0,0,0,1,100
TM,SMART,USD,1,0,1,0,0,1,100
LBRDK,SMART,USD,1,0,1,0,0,1,100
AWK,SMART,USD,1,0,1,0,0,1,100
AGR,SMART,USD,1,0,1,0,0,1,100
BDX,SMART,USD,1,0,1,0,0,1,100
JAMF,SMART,USD,1,0,1,0,0,1,100
IAC,SMART,USD,1,0,1,0,0,1,100
RCI,SMART,USD,1,0,1,0,0,1,100
ASO,SMART,USD,1,0,1,0,0,1,100
ORCC,SMART,USD,1,0,1,0,0,1,100
RXRX,SMART,USD,1,0,1,0,0,1,100
THC,SMART,USD,24,4,8,8,4,12,50
NTRA,SMART,USD,22,6,5,10,1,11,50
NVCR,SMART,USD,22,2,9,8,3,11,50
FSLR,SMART,USD,20,5,5,9,1,10,50
ZG,SMART,USD,20,5,5,10,0,10,50
BB,SMART,USD,20,4,6,9,1,10,50
TREE,SMART,USD,18,4,5,8,1,9,50
SGRY,SMART,USD,18,4,5,9,0,9,50
PAC,SMART,USD,18,2,7,3,6,9,50
BAK,SMART,USD,18,2,7,5,4,9,50
MRO,SMART,USD,16,5,3,5,3,8,50
WYNN,SMART,USD,16,4,4,5,3,8,50
LB,SMART,USD,16,3,5,4,4,8,50
SPB,SMART,USD,16,3,5,6,2,8,50
VCYT,SMART,USD,16,2,6,7,1,8,50
ARGX,SMART,USD,16,1,7,5,3,8,50
OMI,SMART,USD,14,5,2,6,1,7,50
EDU,SMART,USD,14,4,3,4,3,7,50
NEO,SMART,USD,14,3,4,4,3,7,50
DOOO,SMART,USD,14,3,4,4,3,7,50
INSM,SMART,USD,14,2,5,5,2,7,50
ROCK,SMART,USD,14,1,6,2,5,7,50
NSTG,SMART,USD,14,0,7,7,0,7,50
FND,SMART,USD,12,4,2,6,0,6,50
UPWK,SMART,USD,12,4,2,6,0,6,50
MEOH,SMART,USD,12,3,3,4,2,6,50
SMAR,SMART,USD,12,3,3,4,2,6,50
OKTA,SMART,USD,12,3,3,5,1,6,50
PEGA,SMART,USD,12,3,3,6,0,6,50
WEX,SMART,USD,12,2,4,3,3,6,50
LUV,SMART,USD,12,2,4,3,3,6,50
AEO,SMART,USD,12,2,4,4,2,6,50
CZR,SMART,USD,12,2,4,5,1,6,50
ELY,SMART,USD,12,1,5,2,4,6,50
LAD,SMART,USD,12,1,5,3,3,6,50
FOXF,SMART,USD,12,1,5,4,2,6,50
HWM,SMART,USD,12,1,5,5,1,6,50
CRS,SMART,USD,12,1,5,5,1,6,50
MPLX,SMART,USD,12,0,6,3,3,6,50
JMIA,SMART,USD,10,5,0,5,0,5,50
MTH,SMART,USD,10,3,2,5,0,5,50
AVNT,SMART,USD,10,2,3,1,4,5,50
RBC,SMART,USD,10,2,3,1,4,5,50
ANAT,SMART,USD,10,2,3,2,3,5,50
GT,SMART,USD,10,2,3,2,3,5,50
HTH,SMART,USD,10,2,3,3,2,5,50
NSP,SMART,USD,10,2,3,3,2,5,50
PAGS,SMART,USD,10,2,3,3,2,5,50
WHR,SMART,USD,10,2,3,4,1,5,50
CWST,SMART,USD,10,1,4,2,3,5,50
ESNT,SMART,USD,10,1,4,3,2,5,50
NOVT,SMART,USD,10,1,4,3,2,5,50
TPR,SMART,USD,10,1,4,3,2,5,50
OSK,SMART,USD,10,1,4,3,2,5,50
ON,SMART,USD,10,1,4,3,2,5,50
PLNT,SMART,USD,10,1,4,4,1,5,50
MTZ,SMART,USD,10,1,4,4,1,5,50
HEI,SMART,USD,10,1,4,4,1,5,50
BP,SMART,USD,10,0,5,3,2,5,50
TKR,SMART,USD,10,0,5,4,1,5,50
MAR,SMART,USD,10,0,5,4,1,5,50
PLAN,SMART,USD,8,4,0,1,3,4,50
NKLA,SMART,USD,8,4,0,4,0,4,50
FUTU,SMART,USD,8,3,1,4,0,4,50
RGLD,SMART,USD,8,2,2,3,1,4,50
AIMC,SMART,USD,8,2,2,4,0,4,50
AHCO,SMART,USD,8,2,2,4,0,4,50
FFIV,SMART,USD,8,1,3,2,2,4,50
WERN,SMART,USD,8,1,3,2,2,4,50
PDCO,SMART,USD,8,1,3,2,2,4,50
IBN,SMART,USD,8,1,3,2,2,4,50
IBM,SMART,USD,8,1,3,2,2,4,50
CARG,SMART,USD,8,1,3,2,2,4,50
AMG,SMART,USD,8,1,3,3,1,4,50
TARO,SMART,USD,8,1,3,3,1,4,50
AAON,SMART,USD,8,1,3,3,1,4,50
BFAM,SMART,USD,8,1,3,3,1,4,50
BCC,SMART,USD,8,1,3,3,1,4,50
GFI,SMART,USD,8,1,3,3,1,4,50
FBP,SMART,USD,8,1,3,3,1,4,50
UAA,SMART,USD,8,1,3,3,1,4,50
MSM,SMART,USD,8,1,3,3,1,4,50
PHM,SMART,USD,8,1,3,3,1,4,50
ADV,SMART,USD,8,1,3,3,1,4,50
XLRN,SMART,USD,8,1,3,4,0,4,50
SITE,SMART,USD,8,1,3,4,0,4,50
SONY,SMART,USD,8,0,4,0,4,4,50
CIEN,SMART,USD,8,0,4,1,3,4,50
TT,SMART,USD,8,0,4,1,3,4,50
BIO,SMART,USD,8,0,4,1,3,4,50
COLM,SMART,USD,8,0,4,1,3,4,50
LRCX,SMART,USD,8,0,4,2,2,4,50
NUVA,SMART,USD,8,0,4,2,2,4,50
SAIC,SMART,USD,8,0,4,2,2,4,50
NVT,SMART,USD,8,0,4,2,2,4,50
HAE,SMART,USD,8,0,4,2,2,4,50
QLYS,SMART,USD,8,0,4,3,1,4,50
AUB,SMART,USD,8,0,4,3,1,4,50
ULTA,SMART,USD,8,0,4,3,1,4,50
EMR,SMART,USD,8,0,4,3,1,4,50
MC,SMART,USD,8,0,4,4,0,4,50
IMAB,SMART,USD,6,3,0,3,0,3,50
SPT,SMART,USD,6,3,0,3,0,3,50
MP,SMART,USD,6,3,0,3,0,3,50
DM,SMART,USD,6,3,0,3,0,3,50
ILMN,SMART,USD,6,2,1,0,3,3,50
ZION,SMART,USD,6,2,1,1,2,3,50
ABM,SMART,USD,6,2,1,1,2,3,50
EBAY,SMART,USD,6,2,1,1,2,3,50
FOX,SMART,USD,6,2,1,2,1,3,50
PFG,SMART,USD,6,2,1,3,0,3,50
FTDR,SMART,USD,6,2,1,3,0,3,50
PTON,SMART,USD,6,2,1,3,0,3,50
DKNG,SMART,USD,6,2,1,3,0,3,50
CHTR,SMART,USD,6,1,2,0,3,3,50
UFPI,SMART,USD,6,1,2,1,2,3,50
VRTX,SMART,USD,6,1,2,1,2,3,50
SNA,SMART,USD,6,1,2,1,2,3,50
DVA,SMART,USD,6,1,2,1,2,3,50
MMP,SMART,USD,6,1,2,1,2,3,50
ITW,SMART,USD,6,1,2,1,2,3,50
TW,SMART,USD,6,1,2,1,2,3,50
SNPS,SMART,USD,6,1,2,1,2,3,50
KW,SMART,USD,6,1,2,2,1,3,50
GDDY,SMART,USD,6,1,2,2,1,3,50
KWR,SMART,USD,6,1,2,2,1,3,50
EVBG,SMART,USD,6,1,2,2,1,3,50
MANT,SMART,USD,6,1,2,2,1,3,50
BBY,SMART,USD,6,1,2,2,1,3,50
PLXS,SMART,USD,6,1,2,2,1,3,50
CINF,SMART,USD,6,1,2,2,1,3,50
NLSN,SMART,USD,6,1,2,3,0,3,50
TLK,SMART,USD,6,0,3,0,3,3,50
COG,SMART,USD,6,0,3,0,3,3,50
SRCL,SMART,USD,6,0,3,0,3,3,50
FCN,SMART,USD,6,0,3,1,2,3,50
ETN,SMART,USD,6,0,3,1,2,3,50
AVT,SMART,USD,6,0,3,1,2,3,50
LSPD,SMART,USD,6,0,3,1,2,3,50
FFIN,SMART,USD,6,0,3,2,1,3,50
SFBS,SMART,USD,6,0,3,2,1,3,50
MXIM,SMART,USD,6,0,3,2,1,3,50
AME,SMART,USD,6,0,3,2,1,3,50
BOH,SMART,USD,6,0,3,2,1,3,50
GMED,SMART,USD,6,0,3,2,1,3,50
USB,SMART,USD,6,0,3,2,1,3,50
EA,SMART,USD,6,0,3,2,1,3,50
VTRS,SMART,USD,6,0,3,2,1,3,50
CPRT,SMART,USD,6,0,3,2,1,3,50
RS,SMART,USD,6,0,3,2,1,3,50
HLT,SMART,USD,6,0,3,3,0,3,50
AGO,SMART,USD,6,0,3,3,0,3,50
SLAB,SMART,USD,6,0,3,3,0,3,50
PNR,SMART,USD,6,0,3,3,0,3,50
PKG,SMART,USD,6,0,3,3,0,3,50
MKL,SMART,USD,6,0,3,3,0,3,50
HIG,SMART,USD,6,0,3,3,0,3,50
BAM,SMART,USD,4,2,0,1,1,2,50
DDOG,SMART,USD,4,2,0,2,0,2,50
BLI,SMART,USD,4,2,0,2,0,2,50
ROOT,SMART,USD,4,2,0,2,0,2,50
HUBB,SMART,USD,4,1,1,0,2,2,50
UL,SMART,USD,4,1,1,0,2,2,50
QRVO,SMART,USD,4,1,1,1,1,2,50
CI,SMART,USD,4,1,1,1,1,2,50
ADP,SMART,USD,4,1,1,1,1,2,50
GRMN,SMART,USD,4,1,1,1,1,2,50
PPL,SMART,USD,4,1,1,1,1,2,50
HDB,SMART,USD,4,1,1,1,1,2,50
NOW,SMART,USD,4,1,1,1,1,2,50
UGI,SMART,USD,4,1,1,1,1,2,50
MMM,SMART,USD,4,1,1,1,1,2,50
PBA,SMART,USD,4,1,1,1,1,2,50
RNR,SMART,USD,4,1,1,2,0,2,50
ADBE,SMART,USD,4,1,1,2,0,2,50
CRM,SMART,USD,4,1,1,2,0,2,50
WDAY,SMART,USD,4,1,1,2,0,2,50
EME,SMART,USD,4,1,1,2,0,2,50
OTEX,SMART,USD,4,1,1,2,0,2,50
GFL,SMART,USD,4,1,1,2,0,2,50
GNTX,SMART,USD,4,0,2,0,2,2,50
IHG,SMART,USD,4,0,2,0,2,2,50
ORCL,SMART,USD,4,0,2,0,2,2,50
FDS,SMART,USD,4,0,2,0,2,2,50
FNF,SMART,USD,4,0,2,0,2,2,50
MPWR,SMART,USD,4,0,2,0,2,2,50
WIT,SMART,USD,4,0,2,0,2,2,50
ASB,SMART,USD,4,0,2,1,1,2,50
JPM,SMART,USD,4,0,2,1,1,2,50
EVR,SMART,USD,4,0,2,1,1,2,50
MCD,SMART,USD,4,0,2,1,1,2,50
COST,SMART,USD,4,0,2,1,1,2,50
CFR,SMART,USD,4,0,2,1,1,2,50
RLI,SMART,USD,4,0,2,1,1,2,50
SJR,SMART,USD,4,0,2,1,1,2,50
LHCG,SMART,USD,4,0,2,1,1,2,50
LANC,SMART,USD,4,0,2,1,1,2,50
CVX,SMART,USD,4,0,2,1,1,2,50
FAF,SMART,USD,4,0,2,1,1,2,50
CWK,SMART,USD,4,0,2,1,1,2,50
ATR,SMART,USD,4,0,2,1,1,2,50
HD,SMART,USD,4,0,2,1,1,2,50
UPS,SMART,USD,4,0,2,1,1,2,50
KHC,SMART,USD,4,0,2,1,1,2,50
TMUS,SMART,USD,4,0,2,1,1,2,50
SLV,SMART,USD,4,0,2,1,1,2,50
WTRG,SMART,USD,4,0,2,1,1,2,50
MFC,SMART,USD,4,0,2,2,0,2,50
CQP,SMART,USD,4,0,2,2,0,2,50
BK,SMART,USD,4,0,2,2,0,2,50
ACN,SMART,USD,4,0,2,2,0,2,50
BPOP,SMART,USD,4,0,2,2,0,2,50
ENB,SMART,USD,4,0,2,2,0,2,50
LAUR,SMART,USD,4,0,2,2,0,2,50
DLB,SMART,USD,4,0,2,2,0,2,50
SR,SMART,USD,4,0,2,2,0,2,50
LPRO,SMART,USD,4,0,2,2,0,2,50
NSC,SMART,USD,2,1,0,0,1,1,50
D,SMART,USD,2,1,0,0,1,1,50
DRVN,SMART,USD,2,1,0,0,1,1,50
SJM,SMART,USD,2,1,0,1,0,1,50
RY,SMART,USD,2,1,0,1,0,1,50
GOCO,SMART,USD,2,1,0,1,0,1,50
GDRX,SMART,USD,2,1,0,1,0,1,50
ARVL,SMART,USD,2,1,0,1,0,1,50
AAN,SMART,USD,2,1,0,1,0,1,50
ABCM,SMART,USD,2,1,0,1,0,1,50
LESL,SMART,USD,2,1,0,1,0,1,50
POSH,SMART,USD,2,1,0,1,0,1,50
ARRY,SMART,USD,2,1,0,1,0,1,50
KT,SMART,USD,2,0,1,0,1,1,50
HRL,SMART,USD,2,0,1,0,1,1,50
MNST,SMART,USD,2,0,1,0,1,1,50
ED,SMART,USD,2,0,1,0,1,1,50
HE,SMART,USD,2,0,1,0,1,1,50
RMD,SMART,USD,2,0,1,1,0,1,50
NEOG,SMART,USD,2,0,1,1,0,1,50
NEM,SMART,USD,2,0,1,1,0,1,50
AOS,SMART,USD,2,0,1,1,0,1,50
LNT,SMART,USD,2,0,1,1,0,1,50
BRO,SMART,USD,2,0,1,1,0,1,50
IWM,SMART,USD,2,0,1,1,0,1,50
MRK,SMART,USD,2,0,1,1,0,1,50
APD,SMART,USD,2,0,1,1,0,1,50
NTCO,SMART,USD,2,0,1,1,0,1,50
AVA,SMART,USD,2,0,1,1,0,1,50
ACI,SMART,USD,2,0,1,1,0,1,50
EBC,SMART,USD,2,0,1,1,0,1,50
TIXT,SMART,USD,2,0,1,1,0,1,50
WGO,SMART,USD,21,4,6,7,4,10,47.62
VNET,SMART,USD,21,4,6,9,2,10,47.62
TEVA,SMART,USD,19,4,5,5,5,9,47.37
OPK,SMART,USD,19,4,5,9,1,9,47.37
AMC,SMART,USD,19,3,6,9,1,9,47.37
AXON,SMART,USD,19,1,8,8,2,9,47.37
CVNA,SMART,USD,17,7,1,8,1,8,47.06
TTD,SMART,USD,17,4,4,7,2,8,47.06
YY,SMART,USD,17,3,5,6,3,8,47.06
SNBR,SMART,USD,17,3,5,8,1,8,47.06
GDS,SMART,USD,15,6,1,6,2,7,46.67
PHI,SMART,USD,15,1,6,5,3,7,46.67
FIVN,SMART,USD,15,1,6,6,2,7,46.67
SNAP,SMART,USD,15,0,7,8,0,7,46.67
STMP,SMART,USD,26,3,9,12,2,12,46.15
AEIS,SMART,USD,13,4,2,6,1,6,46.15
LITE,SMART,USD,13,4,2,7,0,6,46.15
AX,SMART,USD,13,3,3,1,6,6,46.15
TRGP,SMART,USD,13,3,3,4,3,6,46.15
TXT,SMART,USD,13,3,3,5,2,6,46.15
HUBS,SMART,USD,13,3,3,5,2,6,46.15
CACC,SMART,USD,13,3,3,6,1,6,46.15
RARE,SMART,USD,13,3,3,7,0,6,46.15
PENN,SMART,USD,13,3,3,7,0,6,46.15
SSL,SMART,USD,13,2,4,3,4,6,46.15
RNG,SMART,USD,13,2,4,3,4,6,46.15
OLN,SMART,USD,13,2,4,3,4,6,46.15
VICR,SMART,USD,13,2,4,7,0,6,46.15
SIG,SMART,USD,13,2,4,7,0,6,46.15
HAL,SMART,USD,13,1,5,2,5,6,46.15
PZZA,SMART,USD,13,1,5,2,5,6,46.15
TRMB,SMART,USD,13,1,5,4,3,6,46.15
ALV,SMART,USD,13,0,6,3,4,6,46.15
APPS,SMART,USD,24,10,1,13,0,11,45.83
PACB,SMART,USD,24,7,4,11,2,11,45.83
APPN,SMART,USD,11,5,0,6,0,5,45.45
LGIH,SMART,USD,11,4,1,2,4,5,45.45
JELD,SMART,USD,11,3,2,3,3,5,45.45
WES,SMART,USD,11,3,2,4,2,5,45.45
AR,SMART,USD,11,3,2,6,0,5,45.45
VIACA,SMART,USD,11,3,2,6,0,5,45.45
WDC,SMART,USD,11,2,3,4,2,5,45.45
TSEM,SMART,USD,11,2,3,4,2,5,45.45
ABMD,SMART,USD,11,2,3,4,2,5,45.45
TECK,SMART,USD,11,2,3,5,1,5,45.45
AGCO,SMART,USD,11,2,3,5,1,5,45.45
FIZZ,SMART,USD,11,2,3,5,1,5,45.45
SAIL,SMART,USD,11,2,3,5,1,5,45.45
LAZ,SMART,USD,11,2,3,6,0,5,45.45
SAVE,SMART,USD,11,1,4,2,4,5,45.45
MAT,SMART,USD,11,1,4,2,4,5,45.45
THS,SMART,USD,11,1,4,3,3,5,45.45
MANU,SMART,USD,11,1,4,3,3,5,45.45
PXD,SMART,USD,11,1,4,3,3,5,45.45
NUAN,SMART,USD,11,1,4,4,2,5,45.45
BCO,SMART,USD,11,1,4,4,2,5,45.45
ACIW,SMART,USD,11,1,4,4,2,5,45.45
CAE,SMART,USD,11,1,4,5,1,5,45.45
CHX,SMART,USD,11,1,4,5,1,5,45.45
GOLF,SMART,USD,11,0,5,1,5,5,45.45
BCS,SMART,USD,11,0,5,2,4,5,45.45
AG,SMART,USD,20,5,4,8,3,9,45
BRFS,SMART,USD,20,1,8,5,6,9,45
AAL,SMART,USD,18,4,4,7,3,8,44.44
W,SMART,USD,18,4,4,7,3,8,44.44
CDNA,SMART,USD,18,4,4,10,0,8,44.44
ETSY,SMART,USD,18,3,5,8,2,8,44.44
BZUN,SMART,USD,18,3,5,8,2,8,44.44
UGP,SMART,USD,18,1,7,6,4,8,44.44
PODD,SMART,USD,9,3,1,2,3,4,44.44
ARVN,SMART,USD,9,3,1,5,0,4,44.44
PKX,SMART,USD,9,2,2,0,5,4,44.44
LCII,SMART,USD,9,2,2,2,3,4,44.44
WWW,SMART,USD,9,2,2,3,2,4,44.44
CAKE,SMART,USD,9,2,2,3,2,4,44.44
NSIT,SMART,USD,9,2,2,4,1,4,44.44
ADPT,SMART,USD,9,2,2,4,1,4,44.44
GNRC,SMART,USD,9,1,3,1,4,4,44.44
LNC,SMART,USD,9,1,3,2,3,4,44.44
EMN,SMART,USD,9,1,3,2,3,4,44.44
WOR,SMART,USD,9,1,3,3,2,4,44.44
TMHC,SMART,USD,9,1,3,3,2,4,44.44
CCMP,SMART,USD,9,1,3,3,2,4,44.44
AMZN,SMART,USD,9,1,3,3,2,4,44.44
ESGR,SMART,USD,9,1,3,3,2,4,44.44
PINS,SMART,USD,9,1,3,3,2,4,44.44
CGAU,SMART,USD,9,1,3,4,1,4,44.44
JCOM,SMART,USD,9,1,3,4,1,4,44.44
BILI,SMART,USD,9,1,3,4,1,4,44.44
WSC,SMART,USD,9,1,3,5,0,4,44.44
PSO,SMART,USD,9,0,4,0,5,4,44.44
TIMB,SMART,USD,9,0,4,2,3,4,44.44
LIVN,SMART,USD,9,0,4,3,2,4,44.44
TGNA,SMART,USD,9,0,4,4,1,4,44.44
CCK,SMART,USD,9,0,4,4,1,4,44.44
NTES,SMART,USD,9,0,4,4,1,4,44.44
BBBY,SMART,USD,16,6,1,6,3,7,43.75
BGNE,SMART,USD,16,5,2,7,2,7,43.75
SID,SMART,USD,16,5,2,8,1,7,43.75
ADT,SMART,USD,16,4,3,8,1,7,43.75
WIX,SMART,USD,16,2,5,8,1,7,43.75
HTHT,SMART,USD,16,1,6,7,2,7,43.75
X,SMART,USD,23,7,3,9,4,10,43.48
SWAV,SMART,USD,14,5,1,7,1,6,42.86
EBS,SMART,USD,14,4,2,5,3,6,42.86
IONS,SMART,USD,14,4,2,7,1,6,42.86
KRNT,SMART,USD,14,3,3,7,1,6,42.86
PCG,SMART,USD,14,3,3,8,0,6,42.86
QDEL,SMART,USD,14,2,4,4,4,6,42.86
GRUB,SMART,USD,14,2,4,5,3,6,42.86
ELP,SMART,USD,14,1,5,4,4,6,42.86
EXPE,SMART,USD,14,1,5,5,3,6,42.86
EXEL,SMART,USD,14,1,5,7,1,6,42.86
RYAAY,SMART,USD,14,0,6,4,4,6,42.86
KRTX,SMART,USD,7,3,0,3,1,3,42.86
RVLV,SMART,USD,7,2,1,3,1,3,42.86
DAN,SMART,USD,7,2,1,4,0,3,42.86
ACM,SMART,USD,7,1,2,0,4,3,42.86
EW,SMART,USD,7,1,2,1,3,3,42.86
CS,SMART,USD,7,1,2,1,3,3,42.86
MKTX,SMART,USD,7,1,2,1,3,3,42.86
Y,SMART,USD,7,1,2,1,3,3,42.86
ATH,SMART,USD,7,1,2,1,3,3,42.86
MUSA,SMART,USD,7,1,2,1,3,3,42.86
CNC,SMART,USD,7,1,2,2,2,3,42.86
XRAY,SMART,USD,7,1,2,2,2,3,42.86
ICL,SMART,USD,7,1,2,2,2,3,42.86
SE,SMART,USD,7,1,2,2,2,3,42.86
SRE,SMART,USD,7,1,2,2,2,3,42.86
GS,SMART,USD,7,1,2,3,1,3,42.86
TDS,SMART,USD,7,1,2,3,1,3,42.86
LVS,SMART,USD,7,1,2,3,1,3,42.86
USFD,SMART,USD,7,1,2,4,0,3,42.86
NFLX,SMART,USD,7,1,2,4,0,3,42.86
KNSL,SMART,USD,7,1,2,4,0,3,42.86
VST,SMART,USD,7,1,2,4,0,3,42.86
WDFC,SMART,USD,7,1,2,4,0,3,42.86
SDGR,SMART,USD,7,1,2,4,0,3,42.86
CSGP,SMART,USD,7,0,3,0,4,3,42.86
VOD,SMART,USD,7,0,3,1,3,3,42.86
CACI,SMART,USD,7,0,3,1,3,3,42.86
FHI,SMART,USD,7,0,3,2,2,3,42.86
RTX,SMART,USD,7,0,3,2,2,3,42.86
ICLR,SMART,USD,7,0,3,2,2,3,42.86
MAIN,SMART,USD,7,0,3,2,2,3,42.86
LHX,SMART,USD,7,0,3,3,1,3,42.86
IBTX,SMART,USD,7,0,3,3,1,3,42.86
BLKB,SMART,USD,7,0,3,3,1,3,42.86
HBAN,SMART,USD,7,0,3,3,1,3,42.86
BMI,SMART,USD,7,0,3,3,1,3,42.86
LKQ,SMART,USD,7,0,3,3,1,3,42.86
NUE,SMART,USD,7,0,3,3,1,3,42.86
BOKF,SMART,USD,7,0,3,3,1,3,42.86
SCI,SMART,USD,7,0,3,3,1,3,42.86
INOV,SMART,USD,7,0,3,4,0,3,42.86
ALLK,SMART,USD,12,4,1,7,0,5,41.67
SABR,SMART,USD,12,3,2,3,4,5,41.67
LULU,SMART,USD,12,3,2,3,4,5,41.67
OMF,SMART,USD,12,2,3,4,3,5,41.67
CORT,SMART,USD,12,2,3,5,2,5,41.67
HMY,SMART,USD,12,2,3,6,1,5,41.67
ENBL,SMART,USD,12,2,3,7,0,5,41.67
BPMC,SMART,USD,12,2,3,7,0,5,41.67
BC,SMART,USD,12,1,4,5,2,5,41.67
ALK,SMART,USD,12,1,4,5,2,5,41.67
HALO,SMART,USD,12,1,4,7,0,5,41.67
MOH,SMART,USD,12,0,5,2,5,5,41.67
UNVR,SMART,USD,12,0,5,4,3,5,41.67
WPM,SMART,USD,12,0,5,6,1,5,41.67
SFIX,SMART,USD,17,6,1,9,1,7,41.18
SQ,SMART,USD,17,5,2,10,0,7,41.18
GME,SMART,USD,17,4,3,6,4,7,41.18
HES,SMART,USD,17,4,3,7,3,7,41.18
KTOS,SMART,USD,17,4,3,8,2,7,41.18
CDLX,SMART,USD,17,4,3,9,1,7,41.18
DVN,SMART,USD,17,3,4,7,3,7,41.18
GKOS,SMART,USD,17,3,4,8,2,7,41.18
APA,SMART,USD,17,3,4,8,2,7,41.18
TRIP,SMART,USD,17,2,5,8,2,7,41.18
RCM,SMART,USD,17,2,5,8,2,7,41.18
MITK,SMART,USD,17,1,6,10,0,7,41.18
IOVA,SMART,USD,20,7,1,12,0,8,40
VCEL,SMART,USD,20,5,3,12,0,8,40
SEDG,SMART,USD,20,4,4,10,2,8,40
BLDP,SMART,USD,15,4,2,9,0,6,40
ADNT,SMART,USD,15,3,3,7,2,6,40
ANGI,SMART,USD,15,3,3,8,1,6,40
PTCT,SMART,USD,15,3,3,8,1,6,40
MED,SMART,USD,15,3,3,9,0,6,40
ITUB,SMART,USD,15,0,6,5,4,6,40
COP,SMART,USD,10,3,1,3,3,4,40
URI,SMART,USD,10,3,1,4,2,4,40
BECN,SMART,USD,10,3,1,6,0,4,40
ARNA,SMART,USD,10,3,1,6,0,4,40
UA,SMART,USD,10,2,2,3,3,4,40
F,SMART,USD,10,2,2,3,3,4,40
NCLH,SMART,USD,10,2,2,5,1,4,40
CLF,SMART,USD,10,2,2,5,1,4,40
IHRT,SMART,USD,10,2,2,6,0,4,40
WWD,SMART,USD,10,1,3,2,4,4,40
MIDD,SMART,USD,10,1,3,3,3,4,40
WLK,SMART,USD,10,1,3,3,3,4,40
KBR,SMART,USD,10,1,3,4,2,4,40
FEYE,SMART,USD,10,1,3,4,2,4,40
TTEC,SMART,USD,10,1,3,4,2,4,40
WWE,SMART,USD,10,1,3,4,2,4,40
COUP,SMART,USD,10,1,3,5,1,4,40
ZS,SMART,USD,10,1,3,6,0,4,40
NFE,SMART,USD,10,1,3,6,0,4,40
SNN,SMART,USD,10,0,4,1,5,4,40
XRX,SMART,USD,10,0,4,2,4,4,40
NBIX,SMART,USD,10,0,4,3,3,4,40
MHK,SMART,USD,10,0,4,4,2,4,40
WMS,SMART,USD,10,0,4,4,2,4,40
APO,SMART,USD,10,0,4,5,1,4,40
PAYC,SMART,USD,10,0,4,5,1,4,40
BBD,SMART,USD,10,0,4,5,1,4,40
WEN,SMART,USD,5,2,0,2,1,2,40
DBX,SMART,USD,5,2,0,2,1,2,40
ARNC,SMART,USD,5,2,0,2,1,2,40
NOVA,SMART,USD,5,2,0,3,0,2,40
FSR,SMART,USD,5,2,0,3,0,2,40
STE,SMART,USD,5,1,1,0,3,2,40
FNV,SMART,USD,5,1,1,0,3,2,40
ALXN,SMART,USD,5,1,1,0,3,2,40
LBTYA,SMART,USD,5,1,1,1,2,2,40
H,SMART,USD,5,1,1,1,2,2,40
L,SMART,USD,5,1,1,1,2,2,40
GD,SMART,USD,5,1,1,1,2,2,40
AIN,SMART,USD,5,1,1,2,1,2,40
AON,SMART,USD,5,1,1,2,1,2,40
CDK,SMART,USD,5,1,1,2,1,2,40
MTN,SMART,USD,5,1,1,2,1,2,40
NOC,SMART,USD,5,1,1,2,1,2,40
TMO,SMART,USD,5,1,1,2,1,2,40
XYL,SMART,USD,5,1,1,2,1,2,40
E,SMART,USD,5,1,1,2,1,2,40
DOV,SMART,USD,5,1,1,2,1,2,40
CLVT,SMART,USD,5,1,1,2,1,2,40
EQH,SMART,USD,5,1,1,3,0,2,40
CBSH,SMART,USD,5,1,1,3,0,2,40
UMBF,SMART,USD,5,1,1,3,0,2,40
PD,SMART,USD,5,1,1,3,0,2,40
WORK,SMART,USD,5,1,1,3,0,2,40
CAJ,SMART,USD,5,0,2,0,3,2,40
CCEP,SMART,USD,5,0,2,0,3,2,40
CBU,SMART,USD,5,0,2,0,3,2,40
RDY,SMART,USD,5,0,2,0,3,2,40
CNO,SMART,USD,5,0,2,1,2,2,40
PINC,SMART,USD,5,0,2,1,2,2,40
IFF,SMART,USD,5,0,2,1,2,2,40
UHAL,SMART,USD,5,0,2,1,2,2,40
LLY,SMART,USD,5,0,2,1,2,2,40
DCI,SMART,USD,5,0,2,1,2,2,40
TYL,SMART,USD,5,0,2,1,2,2,40
TBT,SMART,USD,5,0,2,1,2,2,40
GWW,SMART,USD,5,0,2,1,2,2,40
BLK,SMART,USD,5,0,2,1,2,2,40
YUM,SMART,USD,5,0,2,2,1,2,40
ABCB,SMART,USD,5,0,2,2,1,2,40
G,SMART,USD,5,0,2,2,1,2,40
KMI,SMART,USD,5,0,2,2,1,2,40
VRNT,SMART,USD,5,0,2,2,1,2,40
VRSK,SMART,USD,5,0,2,2,1,2,40
LSXMK,SMART,USD,5,0,2,2,1,2,40
CCOI,SMART,USD,5,0,2,2,1,2,40
KMB,SMART,USD,5,0,2,2,1,2,40
PSFE,SMART,USD,5,0,2,2,1,2,40
SNV,SMART,USD,5,0,2,3,0,2,40
AWI,SMART,USD,5,0,2,3,0,2,40
STL,SMART,USD,5,0,2,3,0,2,40
AES,SMART,USD,5,0,2,3,0,2,40
SIVB,SMART,USD,5,0,2,3,0,2,40
CARR,SMART,USD,5,0,2,3,0,2,40
FBRX,SMART,USD,18,6,1,11,0,7,38.89
TWLO,SMART,USD,18,5,2,11,0,7,38.89
CLR,SMART,USD,18,4,3,10,1,7,38.89
MRCY,SMART,USD,18,3,4,5,6,7,38.89
SBSW,SMART,USD,18,2,5,10,1,7,38.89
JBLU,SMART,USD,13,4,1,5,3,5,38.46
STNE,SMART,USD,13,3,2,6,2,5,38.46
CADE,SMART,USD,13,3,2,7,1,5,38.46
LECO,SMART,USD,13,2,3,3,5,5,38.46
ALNY,SMART,USD,13,2,3,5,3,5,38.46
BOX,SMART,USD,13,2,3,6,2,5,38.46
DIOD,SMART,USD,13,1,4,3,5,5,38.46
DXCM,SMART,USD,13,1,4,4,4,5,38.46
AUY,SMART,USD,13,1,4,7,1,5,38.46
JOBS,SMART,USD,13,1,4,7,1,5,38.46
COOP,SMART,USD,13,1,4,8,0,5,38.46
DB,SMART,USD,13,0,5,2,6,5,38.46
AU,SMART,USD,13,0,5,3,5,5,38.46
AMKR,SMART,USD,13,0,5,6,2,5,38.46
VIPS,SMART,USD,21,5,3,9,4,8,38.1
ATCO,SMART,USD,16,4,2,8,2,6,37.5
ITCI,SMART,USD,16,2,4,10,0,6,37.5
NWG,SMART,USD,16,1,5,5,5,6,37.5
PBR,SMART,USD,16,1,5,9,1,6,37.5
COMM,SMART,USD,16,0,6,6,4,6,37.5
VEEV,SMART,USD,8,2,1,2,3,3,37.5
UTHR,SMART,USD,8,2,1,3,2,3,37.5
FDX,SMART,USD,8,2,1,3,2,3,37.5
IBKR,SMART,USD,8,2,1,3,2,3,37.5
ALLO,SMART,USD,8,2,1,4,1,3,37.5
RCKT,SMART,USD,8,2,1,5,0,3,37.5
PGNY,SMART,USD,8,2,1,5,0,3,37.5
TTWO,SMART,USD,8,1,2,1,4,3,37.5
INTC,SMART,USD,8,1,2,2,3,3,37.5
JAZZ,SMART,USD,8,1,2,2,3,3,37.5
MLM,SMART,USD,8,1,2,2,3,3,37.5
BWXT,SMART,USD,8,1,2,2,3,3,37.5
BX,SMART,USD,8,1,2,3,2,3,37.5
MATX,SMART,USD,8,1,2,3,2,3,37.5
HCA,SMART,USD,8,1,2,3,2,3,37.5
FTI,SMART,USD,8,1,2,3,2,3,37.5
NMR,SMART,USD,8,0,3,1,4,3,37.5
WPP,SMART,USD,8,0,3,2,3,3,37.5
TPH,SMART,USD,8,0,3,2,3,3,37.5
GMAB,SMART,USD,8,0,3,2,3,3,37.5
BWA,SMART,USD,8,0,3,3,2,3,37.5
ARES,SMART,USD,8,0,3,3,2,3,37.5
AB,SMART,USD,8,0,3,3,2,3,37.5
MGA,SMART,USD,8,0,3,3,2,3,37.5
FAST,SMART,USD,8,0,3,3,2,3,37.5
HHC,SMART,USD,8,0,3,3,2,3,37.5
MTG,SMART,USD,8,0,3,3,2,3,37.5
BAC,SMART,USD,8,0,3,3,2,3,37.5
RUSHA,SMART,USD,8,0,3,4,1,3,37.5
DKS,SMART,USD,8,0,3,4,1,3,37.5
AN,SMART,USD,8,0,3,4,1,3,37.5
CNQ,SMART,USD,8,0,3,4,1,3,37.5
UBER,SMART,USD,8,0,3,4,1,3,37.5
SLM,SMART,USD,8,0,3,5,0,3,37.5
NG,SMART,USD,8,0,3,5,0,3,37.5
OSTK,SMART,USD,27,7,3,15,2,10,37.04
TRQ,SMART,USD,19,5,2,10,2,7,36.84
AGIO,SMART,USD,19,4,3,11,1,7,36.84
EBR,SMART,USD,19,3,4,8,4,7,36.84
CC,SMART,USD,19,3,4,10,2,7,36.84
TGTX,SMART,USD,22,8,0,13,1,8,36.36
MGY,SMART,USD,11,3,1,5,2,4,36.36
ARMK,SMART,USD,11,2,2,3,4,4,36.36
EQT,SMART,USD,11,2,2,5,2,4,36.36
CGNX,SMART,USD,11,1,3,2,5,4,36.36
HSIC,SMART,USD,11,1,3,2,5,4,36.36
FWONA,SMART,USD,11,1,3,3,4,4,36.36
DAL,SMART,USD,11,1,3,5,2,4,36.36
VC,SMART,USD,11,1,3,6,1,4,36.36
SIX,SMART,USD,11,1,3,7,0,4,36.36
GLPG,SMART,USD,11,0,4,2,5,4,36.36
CENT,SMART,USD,11,0,4,3,4,4,36.36
APPF,SMART,USD,11,0,4,3,4,4,36.36
TOL,SMART,USD,11,0,4,4,3,4,36.36
DXC,SMART,USD,11,0,4,5,2,4,36.36
GE,SMART,USD,14,4,1,8,1,5,35.71
RL,SMART,USD,14,2,3,5,4,5,35.71
GGB,SMART,USD,14,1,4,6,3,5,35.71
MELI,SMART,USD,17,4,2,8,3,6,35.29
RETA,SMART,USD,17,4,2,11,0,6,35.29
YELP,SMART,USD,17,3,3,7,4,6,35.29
CLDR,SMART,USD,17,3,3,8,3,6,35.29
TNDM,SMART,USD,23,6,2,14,1,8,34.78
CELH,SMART,USD,23,5,3,13,2,8,34.78
FCEL,SMART,USD,26,6,3,17,0,9,34.62
DQ,SMART,USD,26,5,4,17,0,9,34.62
NVAX,SMART,USD,32,8,3,21,0,11,34.38
ARWR,SMART,USD,32,6,5,18,3,11,34.38
FATE,SMART,USD,24,5,3,14,2,8,33.33
NIO,SMART,USD,18,5,1,12,0,6,33.33
AYX,SMART,USD,18,4,2,8,4,6,33.33
CCXI,SMART,USD,18,2,4,10,2,6,33.33
BRKS,SMART,USD,15,2,3,8,2,5,33.33
ET,SMART,USD,15,2,3,9,1,5,33.33
SHAK,SMART,USD,15,1,4,8,2,5,33.33
HQY,SMART,USD,15,0,5,8,2,5,33.33
PPBI,SMART,USD,15,0,5,9,1,5,33.33
GLOB,SMART,USD,12,2,2,5,3,4,33.33
BYD,SMART,USD,12,2,2,6,2,4,33.33
CGC,SMART,USD,12,2,2,8,0,4,33.33
EC,SMART,USD,12,1,3,3,5,4,33.33
COHR,SMART,USD,12,1,3,6,2,4,33.33
PII,SMART,USD,12,1,3,6,2,4,33.33
NTNX,SMART,USD,12,1,3,6,2,4,33.33
NLOK,SMART,USD,12,0,4,4,4,4,33.33
JBT,SMART,USD,12,0,4,5,3,4,33.33
QTWO,SMART,USD,12,0,4,6,2,4,33.33
HLF,SMART,USD,12,0,4,7,1,4,33.33
CRNC,SMART,USD,9,3,0,4,2,3,33.33
BTI,SMART,USD,9,1,2,0,6,3,33.33
CW,SMART,USD,9,1,2,3,3,3,33.33
IART,SMART,USD,9,1,2,3,3,3,33.33
BHF,SMART,USD,9,1,2,3,3,3,33.33
JBL,SMART,USD,9,1,2,4,2,3,33.33
IBP,SMART,USD,9,1,2,4,2,3,33.33
KKR,SMART,USD,9,1,2,4,2,3,33.33
GPI,SMART,USD,9,1,2,5,1,3,33.33
ENR,SMART,USD,9,1,2,5,1,3,33.33
QRTEA,SMART,USD,9,1,2,5,1,3,33.33
QGEN,SMART,USD,9,0,3,1,5,3,33.33
PUK,SMART,USD,9,0,3,2,4,3,33.33
SWKS,SMART,USD,9,0,3,3,3,3,33.33
IPGP,SMART,USD,9,0,3,3,3,3,33.33
NGVT,SMART,USD,9,0,3,4,2,3,33.33
PRGO,SMART,USD,9,0,3,5,1,3,33.33
FTNT,SMART,USD,9,0,3,5,1,3,33.33
CVLT,SMART,USD,9,0,3,5,1,3,33.33
QFIN,SMART,USD,6,2,0,4,0,2,33.33
SEE,SMART,USD,6,1,1,0,4,2,33.33
FMC,SMART,USD,6,1,1,1,3,2,33.33
TMX,SMART,USD,6,1,1,1,3,2,33.33
FITB,SMART,USD,6,1,1,2,2,2,33.33
FICO,SMART,USD,6,1,1,2,2,2,33.33
EQNR,SMART,USD,6,1,1,2,2,2,33.33
FLS,SMART,USD,6,1,1,3,1,2,33.33
DPZ,SMART,USD,6,1,1,3,1,2,33.33
SSO,SMART,USD,6,1,1,3,1,2,33.33
WTFC,SMART,USD,6,1,1,4,0,2,33.33
PNW,SMART,USD,6,1,1,4,0,2,33.33
IFS,SMART,USD,6,1,1,4,0,2,33.33
CHWY,SMART,USD,6,1,1,4,0,2,33.33
RIO,SMART,USD,6,0,2,1,3,2,33.33
LSXMA,SMART,USD,6,0,2,1,3,2,33.33
LFC,SMART,USD,6,0,2,1,3,2,33.33
WAT,SMART,USD,6,0,2,1,3,2,33.33
COF,SMART,USD,6,0,2,2,2,2,33.33
CNA,SMART,USD,6,0,2,2,2,2,33.33
CTAS,SMART,USD,6,0,2,2,2,2,33.33
TGT,SMART,USD,6,0,2,2,2,2,33.33
AFG,SMART,USD,6,0,2,2,2,2,33.33
MOR,SMART,USD,6,0,2,2,2,2,33.33
IAA,SMART,USD,6,0,2,2,2,2,33.33
MMC,SMART,USD,6,0,2,3,1,2,33.33
CMC,SMART,USD,6,0,2,3,1,2,33.33
SAP,SMART,USD,6,0,2,3,1,2,33.33
CVBF,SMART,USD,6,0,2,3,1,2,33.33
HRC,SMART,USD,6,0,2,3,1,2,33.33
GBCI,SMART,USD,6,0,2,3,1,2,33.33
CHE,SMART,USD,6,0,2,3,1,2,33.33
CMA,SMART,USD,6,0,2,3,1,2,33.33
CMI,SMART,USD,6,0,2,3,1,2,33.33
GATX,SMART,USD,6,0,2,3,1,2,33.33
TRU,SMART,USD,6,0,2,3,1,2,33.33
RACE,SMART,USD,6,0,2,4,0,2,33.33
MA,SMART,USD,6,0,2,4,0,2,33.33
NTR,SMART,USD,3,1,0,0,2,1,33.33
MDLZ,SMART,USD,3,1,0,1,1,1,33.33
LEN,SMART,USD,3,1,0,1,1,1,33.33
MPLN,SMART,USD,3,1,0,1,1,1,33.33
BEKE,SMART,USD,3,1,0,1,1,1,33.33
SCL,SMART,USD,3,1,0,2,0,1,33.33
MSFT,SMART,USD,3,1,0,2,0,1,33.33
DTE,SMART,USD,3,1,0,2,0,1,33.33
AJG,SMART,USD,3,1,0,2,0,1,33.33
NVST,SMART,USD,3,1,0,2,0,1,33.33
VRM,SMART,USD,3,1,0,2,0,1,33.33
BIGC,SMART,USD,3,1,0,2,0,1,33.33
OM,SMART,USD,3,1,0,2,0,1,33.33
CVAC,SMART,USD,3,1,0,2,0,1,33.33
SEER,SMART,USD,3,1,0,2,0,1,33.33
NVO,SMART,USD,3,0,1,0,2,1,33.33
PNM,SMART,USD,3,0,1,0,2,1,33.33
JNJ,SMART,USD,3,0,1,0,2,1,33.33
FLO,SMART,USD,3,0,1,1,1,1,33.33
ATVI,SMART,USD,3,0,1,1,1,1,33.33
MTB,SMART,USD,3,0,1,1,1,1,33.33
FIS,SMART,USD,3,0,1,1,1,1,33.33
CBOE,SMART,USD,3,0,1,1,1,1,33.33
SWK,SMART,USD,3,0,1,1,1,1,33.33
WTM,SMART,USD,3,0,1,1,1,1,33.33
UNH,SMART,USD,3,0,1,1,1,1,33.33
WEC,SMART,USD,3,0,1,1,1,1,33.33
VRT,SMART,USD,3,0,1,1,1,1,33.33
SYK,SMART,USD,3,0,1,1,1,1,33.33
BUR,SMART,USD,3,0,1,1,1,1,33.33
MGEE,SMART,USD,3,0,1,2,0,1,33.33
VVV,SMART,USD,3,0,1,2,0,1,33.33
CB,SMART,USD,3,0,1,2,0,1,33.33
GGG,SMART,USD,3,0,1,2,0,1,33.33
COO,SMART,USD,3,0,1,2,0,1,33.33
BSX,SMART,USD,3,0,1,2,0,1,33.33
RE,SMART,USD,3,0,1,2,0,1,33.33
PSN,SMART,USD,3,0,1,2,0,1,33.33
GO,SMART,USD,3,0,1,2,0,1,33.33
JJSF,SMART,USD,3,0,1,2,0,1,33.33
KDP,SMART,USD,3,0,1,2,0,1,33.33
SPY,SMART,USD,3,0,1,2,0,1,33.33
SLQT,SMART,USD,3,0,1,2,0,1,33.33
AMRS,SMART,USD,25,6,2,16,1,8,32
RUN,SMART,USD,22,3,4,14,1,7,31.82
JNCE,SMART,USD,19,4,2,13,0,6,31.58
SHOP,SMART,USD,19,2,4,11,2,6,31.58
XEC,SMART,USD,19,1,5,11,2,6,31.58
JWN,SMART,USD,16,2,3,5,6,5,31.25
PSTG,SMART,USD,16,2,3,10,1,5,31.25
WB,SMART,USD,16,0,5,7,4,5,31.25
ACAD,SMART,USD,16,0,5,9,2,5,31.25
BL,SMART,USD,16,0,5,9,2,5,31.25
REZI,SMART,USD,13,3,1,7,2,4,30.77
FORM,SMART,USD,13,2,2,5,4,4,30.77
AMRC,SMART,USD,13,2,2,8,1,4,30.77
BE,SMART,USD,13,2,2,9,0,4,30.77
TNET,SMART,USD,13,1,3,5,4,4,30.77
LSCC,SMART,USD,13,1,3,5,4,4,30.77
PDD,SMART,USD,13,1,3,9,0,4,30.77
NXPI,SMART,USD,13,0,4,5,4,4,30.77
NEWR,SMART,USD,13,0,4,6,3,4,30.77
TPX,SMART,USD,13,0,4,6,3,4,30.77
ROKU,SMART,USD,20,3,3,13,1,6,30
WBA,SMART,USD,10,1,2,4,3,3,30
ASND,SMART,USD,10,1,2,4,3,3,30
PNFP,SMART,USD,10,1,2,4,3,3,30
NAVI,SMART,USD,10,1,2,5,2,3,30
FLR,SMART,USD,10,1,2,5,2,3,30
EPAM,SMART,USD,10,1,2,6,1,3,30
AMGN,SMART,USD,10,0,3,3,4,3,30
JLL,SMART,USD,10,0,3,3,4,3,30
GWRE,SMART,USD,10,0,3,3,4,3,30
LNG,SMART,USD,10,0,3,4,3,3,30
SCCO,SMART,USD,10,0,3,4,3,3,30
NAV,SMART,USD,10,0,3,4,3,3,30
BRKR,SMART,USD,10,0,3,4,3,3,30
FUL,SMART,USD,10,0,3,5,2,3,30
FRPT,SMART,USD,10,0,3,5,2,3,30
WD,SMART,USD,10,0,3,5,2,3,30
SSRM,SMART,USD,10,0,3,7,0,3,30
DISCA,SMART,USD,17,1,4,7,5,5,29.41
EXPI,SMART,USD,21,6,0,13,2,6,28.57
PLUG,SMART,USD,21,5,1,15,0,6,28.57
SRPT,SMART,USD,21,3,3,11,4,6,28.57
IQ,SMART,USD,14,4,0,9,1,4,28.57
ALGT,SMART,USD,14,2,2,8,2,4,28.57
FRHC,SMART,USD,14,2,2,8,2,4,28.57
LPSN,SMART,USD,14,1,3,9,1,4,28.57
J,SMART,USD,7,2,0,2,3,2,28.57
TAP,SMART,USD,7,2,0,2,3,2,28.57
TRV,SMART,USD,7,2,0,3,2,2,28.57
EAF,SMART,USD,7,2,0,4,1,2,28.57
BPY,SMART,USD,7,2,0,4,1,2,28.57
QS,SMART,USD,7,2,0,5,0,2,28.57
JNPR,SMART,USD,7,1,1,3,2,2,28.57
ASGN,SMART,USD,7,1,1,3,2,2,28.57
JCI,SMART,USD,7,1,1,3,2,2,28.57
WRB,SMART,USD,7,1,1,3,2,2,28.57
DD,SMART,USD,7,1,1,4,1,2,28.57
XOM,SMART,USD,7,1,1,4,1,2,28.57
AVTR,SMART,USD,7,1,1,4,1,2,28.57
AMBA,SMART,USD,7,1,1,5,0,2,28.57
WRK,SMART,USD,7,1,1,5,0,2,28.57
AMP,SMART,USD,7,0,2,1,4,2,28.57
NXST,SMART,USD,7,0,2,2,3,2,28.57
ACGL,SMART,USD,7,0,2,2,3,2,28.57
MCHP,SMART,USD,7,0,2,2,3,2,28.57
CTLT,SMART,USD,7,0,2,2,3,2,28.57
VIAV,SMART,USD,7,0,2,2,3,2,28.57
FRC,SMART,USD,7,0,2,2,3,2,28.57
ITRI,SMART,USD,7,0,2,2,3,2,28.57
KEY,SMART,USD,7,0,2,3,2,2,28.57
AVGO,SMART,USD,7,0,2,3,2,2,28.57
RF,SMART,USD,7,0,2,3,2,2,28.57
UBSI,SMART,USD,7,0,2,3,2,2,28.57
LMT,SMART,USD,7,0,2,3,2,2,28.57
CMG,SMART,USD,7,0,2,3,2,2,28.57
KLIC,SMART,USD,7,0,2,3,2,2,28.57
PSEC,SMART,USD,7,0,2,3,2,2,28.57
FBHS,SMART,USD,7,0,2,3,2,2,28.57
NKE,SMART,USD,7,0,2,3,2,2,28.57
ALLY,SMART,USD,7,0,2,4,1,2,28.57
HELE,SMART,USD,7,0,2,4,1,2,28.57
BLDR,SMART,USD,7,0,2,4,1,2,28.57
LFUS,SMART,USD,7,0,2,4,1,2,28.57
LAZR,SMART,USD,7,0,2,5,0,2,28.57
OVV,SMART,USD,18,2,3,10,3,5,27.78
VEON,SMART,USD,11,2,1,6,2,3,27.27
DCP,SMART,USD,11,2,1,6,2,3,27.27
FTCH,SMART,USD,11,2,1,7,1,3,27.27
WBT,SMART,USD,11,1,2,6,2,3,27.27
MDB,SMART,USD,11,1,2,7,1,3,27.27
HRB,SMART,USD,11,0,3,3,5,3,27.27
WSM,SMART,USD,11,0,3,6,2,3,27.27
PPC,SMART,USD,11,0,3,6,2,3,27.27
ALKS,SMART,USD,11,0,3,7,1,3,27.27
TLRY,SMART,USD,15,3,1,11,0,4,26.67
AMD,SMART,USD,15,2,2,8,3,4,26.67
RDFN,SMART,USD,15,2,2,10,1,4,26.67
FCX,SMART,USD,15,1,3,8,3,4,26.67
STAA,SMART,USD,15,1,3,9,2,4,26.67
MRTX,SMART,USD,24,3,3,15,3,6,25
NKTR,SMART,USD,20,2,3,12,3,5,25
NTLA,SMART,USD,16,4,0,10,2,4,25
BYND,SMART,USD,12,3,0,8,1,3,25
OLED,SMART,USD,12,1,2,6,3,3,25
IGT,SMART,USD,12,1,2,7,2,3,25
LYFT,SMART,USD,12,1,2,8,1,3,25
FWONK,SMART,USD,12,0,3,5,4,3,25
DELL,SMART,USD,12,0,3,6,3,3,25
ATUS,SMART,USD,8,2,0,2,4,2,25
SBS,SMART,USD,8,2,0,3,3,2,25
MKSI,SMART,USD,8,1,1,2,4,2,25
ZLAB,SMART,USD,8,1,1,4,2,2,25
DT,SMART,USD,8,1,1,4,2,2,25
JHG,SMART,USD,8,0,2,1,5,2,25
ING,SMART,USD,8,0,2,2,4,2,25
CG,SMART,USD,8,0,2,2,4,2,25
ZTO,SMART,USD,8,0,2,4,2,2,25
HOG,SMART,USD,8,0,2,4,2,2,25
IMO,SMART,USD,8,0,2,5,1,2,25
BJ,SMART,USD,8,0,2,5,1,2,25
CVET,SMART,USD,8,0,2,6,0,2,25
UNP,SMART,USD,4,1,0,1,2,1,25
NJR,SMART,USD,4,1,0,1,2,1,25
AVY,SMART,USD,4,1,0,2,1,1,25
CASY,SMART,USD,4,1,0,2,1,1,25
BEAM,SMART,USD,4,1,0,2,1,1,25
ZIM,SMART,USD,4,1,0,2,1,1,25
FISV,SMART,USD,4,1,0,3,0,1,25
SNOW,SMART,USD,4,1,0,3,0,1,25
MGNI,SMART,USD,4,1,0,3,0,1,25
PCT,SMART,USD,4,1,0,3,0,1,25
FMS,SMART,USD,4,0,1,0,3,1,25
PM,SMART,USD,4,0,1,0,3,1,25
PBCT,SMART,USD,4,0,1,1,2,1,25
TFSL,SMART,USD,4,0,1,1,2,1,25
CHKP,SMART,USD,4,0,1,1,2,1,25
INTU,SMART,USD,4,0,1,1,2,1,25
GIB,SMART,USD,4,0,1,1,2,1,25
SLGN,SMART,USD,4,0,1,1,2,1,25
ELAN,SMART,USD,4,0,1,1,2,1,25
WLTW,SMART,USD,4,0,1,1,2,1,25
HMC,SMART,USD,4,0,1,1,2,1,25
BRC,SMART,USD,4,0,1,2,1,1,25
CSX,SMART,USD,4,0,1,2,1,1,25
BMY,SMART,USD,4,0,1,2,1,1,25
CTXS,SMART,USD,4,0,1,2,1,1,25
PGR,SMART,USD,4,0,1,2,1,1,25
LII,SMART,USD,4,0,1,2,1,1,25
SVMK,SMART,USD,4,0,1,2,1,1,25
NFG,SMART,USD,4,0,1,2,1,1,25
SBUX,SMART,USD,4,0,1,2,1,1,25
CNP,SMART,USD,4,0,1,2,1,1,25
SO,SMART,USD,4,0,1,2,1,1,25
NEE,SMART,USD,4,0,1,2,1,1,25
TXG,SMART,USD,4,0,1,2,1,1,25
GRA,SMART,USD,4,0,1,3,0,1,25
COLB,SMART,USD,4,0,1,3,0,1,25
AFL,SMART,USD,4,0,1,3,0,1,25
EHC,SMART,USD,4,0,1,3,0,1,25
EIX,SMART,USD,4,0,1,3,0,1,25
DDD,SMART,USD,21,3,2,12,4,5,23.81
TAL,SMART,USD,13,2,1,7,3,3,23.08
ORGO,SMART,USD,13,2,1,9,1,3,23.08
HL,SMART,USD,13,1,2,7,3,3,23.08
MOS,SMART,USD,13,1,2,8,2,3,23.08
ANET,SMART,USD,13,0,3,5,5,3,23.08
ATI,SMART,USD,13,0,3,6,4,3,23.08
RIOT,SMART,USD,22,5,0,17,0,5,22.73
CALX,SMART,USD,18,1,3,10,4,4,22.22
SPOT,SMART,USD,9,2,0,4,3,2,22.22
CWT,SMART,USD,9,1,1,3,4,2,22.22
OZK,SMART,USD,9,1,1,3,4,2,22.22
STLD,SMART,USD,9,1,1,4,3,2,22.22
BAP,SMART,USD,9,1,1,4,3,2,22.22
SHOO,SMART,USD,9,1,1,5,2,2,22.22
NWL,SMART,USD,9,1,1,5,2,2,22.22
PRMW,SMART,USD,9,1,1,7,0,2,22.22
GRFS,SMART,USD,9,0,2,2,5,2,22.22
JBHT,SMART,USD,9,0,2,2,5,2,22.22
RDN,SMART,USD,9,0,2,4,3,2,22.22
DECK,SMART,USD,9,0,2,4,3,2,22.22
TCBI,SMART,USD,9,0,2,4,3,2,22.22
YNDX,SMART,USD,9,0,2,5,2,2,22.22
NVTA,SMART,USD,14,3,0,11,0,3,21.43
ENPH,SMART,USD,29,5,1,22,1,6,20.69
BAND,SMART,USD,15,2,1,9,3,3,20
CCJ,SMART,USD,10,1,1,5,3,2,20
RAMP,SMART,USD,10,1,1,6,2,2,20
AAPL,SMART,USD,10,1,1,7,1,2,20
BA,SMART,USD,10,1,1,8,0,2,20
TCOM,SMART,USD,10,0,2,3,5,2,20
INGR,SMART,USD,5,1,0,1,3,1,20
VMC,SMART,USD,5,1,0,1,3,1,20
THG,SMART,USD,5,1,0,2,2,1,20
KBH,SMART,USD,5,1,0,2,2,1,20
VIR,SMART,USD,5,1,0,3,1,1,20
EEFT,SMART,USD,5,1,0,4,0,1,20
PFPT,SMART,USD,5,1,0,4,0,1,20
INMD,SMART,USD,5,1,0,4,0,1,20
OCFT,SMART,USD,5,1,0,4,0,1,20
DADA,SMART,USD,5,1,0,4,0,1,20
TSCO,SMART,USD,5,0,1,0,4,1,20
KB,SMART,USD,5,0,1,0,4,1,20
TTC,SMART,USD,5,0,1,1,3,1,20
KLAC,SMART,USD,5,0,1,1,3,1,20
GOLD,SMART,USD,5,0,1,1,3,1,20
CTSH,SMART,USD,5,0,1,2,2,1,20
SHW,SMART,USD,5,0,1,2,2,1,20
ALLE,SMART,USD,5,0,1,2,2,1,20
ENIA,SMART,USD,5,0,1,2,2,1,20
SWX,SMART,USD,5,0,1,2,2,1,20
FMX,SMART,USD,5,0,1,2,2,1,20
C,SMART,USD,5,0,1,2,2,1,20
ACA,SMART,USD,5,0,1,2,2,1,20
UNF,SMART,USD,5,0,1,3,1,1,20
SHG,SMART,USD,5,0,1,3,1,1,20
CP,SMART,USD,5,0,1,3,1,1,20
FHB,SMART,USD,5,0,1,3,1,1,20
ROP,SMART,USD,5,0,1,3,1,1,20
GHC,SMART,USD,5,0,1,3,1,1,20
CNMD,SMART,USD,5,0,1,3,1,1,20
COKE,SMART,USD,5,0,1,4,0,1,20
SPXC,SMART,USD,5,0,1,4,0,1,20
WH,SMART,USD,5,0,1,4,0,1,20
MARA,SMART,USD,21,4,0,17,0,4,19.05
DEN,SMART,USD,21,2,2,16,1,4,19.05
TEAM,SMART,USD,11,0,2,4,5,2,18.18
MASI,SMART,USD,11,0,2,4,5,2,18.18
HBI,SMART,USD,11,0,2,7,2,2,18.18
NVDA,SMART,USD,11,0,2,8,1,2,18.18
MTSI,SMART,USD,17,0,3,11,3,3,17.65
IBRX,SMART,USD,24,3,1,20,0,4,16.67
DY,SMART,USD,18,3,0,12,3,3,16.67
LUMN,SMART,USD,12,1,1,7,3,2,16.67
BABA,SMART,USD,12,1,1,8,2,2,16.67
FLT,SMART,USD,6,1,0,2,3,1,16.67
ROK,SMART,USD,6,1,0,2,3,1,16.67
CDW,SMART,USD,6,1,0,4,1,1,16.67
TWST,SMART,USD,6,1,0,5,0,1,16.67
BBIO,SMART,USD,6,1,0,5,0,1,16.67
SI,SMART,USD,6,1,0,5,0,1,16.67
HSBC,SMART,USD,6,0,1,0,5,1,16.67
TECH,SMART,USD,6,0,1,0,5,1,16.67
ZTS,SMART,USD,6,0,1,1,4,1,16.67
TFC,SMART,USD,6,0,1,2,3,1,16.67
CPB,SMART,USD,6,0,1,2,3,1,16.67
NICE,SMART,USD,6,0,1,2,3,1,16.67
CFG,SMART,USD,6,0,1,3,2,1,16.67
VLO,SMART,USD,6,0,1,3,2,1,16.67
SNDR,SMART,USD,6,0,1,3,2,1,16.67
KFY,SMART,USD,6,0,1,4,1,1,16.67
NOMD,SMART,USD,6,0,1,4,1,1,16.67
PFE,SMART,USD,6,0,1,4,1,1,16.67
OKE,SMART,USD,6,0,1,4,1,1,16.67
AEM,SMART,USD,6,0,1,4,1,1,16.67
AMAT,SMART,USD,6,0,1,4,1,1,16.67
HPE,SMART,USD,6,0,1,4,1,1,16.67
MMSI,SMART,USD,6,0,1,5,0,1,16.67
NET,SMART,USD,6,0,1,5,0,1,16.67
JD,SMART,USD,19,2,1,12,4,3,15.79
TSLA,SMART,USD,19,2,1,13,3,3,15.79
YETI,SMART,USD,13,2,0,11,0,2,15.38
MDLA,SMART,USD,7,1,0,6,0,1,14.29
MCO,SMART,USD,7,0,1,0,6,1,14.29
TJX,SMART,USD,7,0,1,1,5,1,14.29
BBL,SMART,USD,7,0,1,2,4,1,14.29
SSB,SMART,USD,7,0,1,3,3,1,14.29
SYNH,SMART,USD,7,0,1,3,3,1,14.29
AY,SMART,USD,7,0,1,4,2,1,14.29
XLE,SMART,USD,7,0,1,4,2,1,14.29
CRON,SMART,USD,7,0,1,6,0,1,14.29
VMI,SMART,USD,8,1,0,4,3,1,12.5
DOYU,SMART,USD,8,1,0,6,1,1,12.5
UNM,SMART,USD,8,0,1,3,4,1,12.5
VALE,SMART,USD,8,0,1,4,3,1,12.5
HOMB,SMART,USD,8,0,1,5,2,1,12.5
ESTC,SMART,USD,8,0,1,5,2,1,12.5
CRH,SMART,USD,9,0,1,4,4,1,11.11
IVZ,SMART,USD,9,0,1,5,3,1,11.11
BBU,SMART,USD,9,0,1,5,3,1,11.11
SMG,SMART,USD,9,0,1,5,3,1,11.11
RH,SMART,USD,10,1,0,7,2,1,10
JOE,SMART,USD,10,0,1,4,5,1,10
CENTA,SMART,USD,10,0,1,4,5,1,10
PCTY,SMART,USD,10,0,1,7,2,1,10
FIX,SMART,USD,11,0,1,5,5,1,9.09
SPLK,SMART,USD,11,0,1,6,4,1,9.09
BKR,SMART,USD,12,1,0,3,8,1,8.33
MTDR,SMART,USD,11,0,0,10,1,0,0
USO,SMART,USD,9,0,0,4,5,0,0
PCRX,SMART,USD,8,0,0,5,3,0,0
ZM,SMART,USD,8,0,0,8,0,0,0
KR,SMART,USD,7,0,0,3,4,0,0
MS,SMART,USD,7,0,0,4,3,0,0
BHP,SMART,USD,6,0,0,1,5,0,0
FE,SMART,USD,6,0,0,3,3,0,0
CDAY,SMART,USD,6,0,0,5,1,0,0
UAL,SMART,USD,6,0,0,5,1,0,0
GILD,SMART,USD,5,0,0,1,4,0,0
LEG,SMART,USD,5,0,0,2,3,0,0
ROST,SMART,USD,5,0,0,2,3,0,0
MDC,SMART,USD,5,0,0,3,2,0,0
SJI,SMART,USD,5,0,0,3,2,0,0
OPCH,SMART,USD,5,0,0,4,1,0,0
EXLS,SMART,USD,4,0,0,1,3,0,0
ALE,SMART,USD,4,0,0,1,3,0,0
NI,SMART,USD,4,0,0,1,3,0,0
FULT,SMART,USD,4,0,0,2,2,0,0
TSN,SMART,USD,4,0,0,2,2,0,0
QSR,SMART,USD,4,0,0,2,2,0,0
AZN,SMART,USD,4,0,0,3,1,0,0
T,SMART,USD,4,0,0,3,1,0,0
POR,SMART,USD,4,0,0,3,1,0,0
ONTO,SMART,USD,4,0,0,4,0,0,0
SKLZ,SMART,USD,4,0,0,4,0,0,0
DLTR,SMART,USD,3,0,0,0,3,0,0
IDA,SMART,USD,3,0,0,1,2,0,0
WTS,SMART,USD,3,0,0,1,2,0,0
WST,SMART,USD,3,0,0,1,2,0,0
APG,SMART,USD,3,0,0,1,2,0,0
CME,SMART,USD,3,0,0,2,1,0,0
BMO,SMART,USD,3,0,0,2,1,0,0
ABB,SMART,USD,3,0,0,2,1,0,0
PEG,SMART,USD,3,0,0,2,1,0,0
JACK,SMART,USD,3,0,0,3,0,0,0
FOUR,SMART,USD,3,0,0,3,0,0,0
RXT,SMART,USD,3,0,0,3,0,0,0
CRSR,SMART,USD,3,0,0,3,0,0,0
UPST,SMART,USD,3,0,0,3,0,0,0
WISH,SMART,USD,3,0,0,3,0,0,0
TRP,SMART,USD,2,0,0,0,2,0,0
EVRG,SMART,USD,2,0,0,0,2,0,0
WOOF,SMART,USD,2,0,0,0,2,0,0
AXP,SMART,USD,2,0,0,1,1,0,0
VRSN,SMART,USD,2,0,0,1,1,0,0
ALL,SMART,USD,2,0,0,1,1,0,0
VZ,SMART,USD,2,0,0,1,1,0,0
VSH,SMART,USD,2,0,0,1,1,0,0
WCN,SMART,USD,2,0,0,1,1,0,0
SON,SMART,USD,2,0,0,1,1,0,0
CERN,SMART,USD,2,0,0,1,1,0,0
DHR,SMART,USD,2,0,0,1,1,0,0
AIZ,SMART,USD,2,0,0,1,1,0,0
DEO,SMART,USD,2,0,0,1,1,0,0
ES,SMART,USD,2,0,0,1,1,0,0
PG,SMART,USD,2,0,0,1,1,0,0
ABT,SMART,USD,2,0,0,1,1,0,0
POOL,SMART,USD,2,0,0,1,1,0,0
EXC,SMART,USD,2,0,0,2,0,0,0
CLX,SMART,USD,2,0,0,2,0,0,0
PAYX,SMART,USD,2,0,0,2,0,0,0
DOX,SMART,USD,2,0,0,2,0,0,0
ETR,SMART,USD,2,0,0,2,0,0,0
OGE,SMART,USD,2,0,0,2,0,0,0
CSL,SMART,USD,2,0,0,2,0,0,0
ACCD,SMART,USD,2,0,0,2,0,0,0
ZI,SMART,USD,2,0,0,2,0,0,0
RPRX,SMART,USD,2,0,0,2,0,0,0
BNR,SMART,USD,2,0,0,2,0,0,0
OZON,SMART,USD,2,0,0,2,0,0,0
CCIV,SMART,USD,2,0,0,2,0,0,0
SANA,SMART,USD,2,0,0,2,0,0,0
U,SMART,USD,2,0,0,2,0,0,0
ABCL,SMART,USD,2,0,0,2,0,0,0
RLX,SMART,USD,2,0,0,2,0,0,0
TSM,SMART,USD,1,0,0,0,1,0,0
CL,SMART,USD,1,0,0,0,1,0,0
MDU,SMART,USD,1,0,0,0,1,0,0
ATO,SMART,USD,1,0,0,0,1,0,0
OGS,SMART,USD,1,0,0,0,1,0,0
HSY,SMART,USD,1,0,0,0,1,0,0
REYN,SMART,USD,1,0,0,0,1,0,0
EXPO,SMART,USD,1,0,0,0,1,0,0
FTS,SMART,USD,1,0,0,1,0,0,0
AEE,SMART,USD,1,0,0,1,0,0,0
PTR,SMART,USD,1,0,0,1,0,0,0
MDT,SMART,USD,1,0,0,1,0,0,0
BNS,SMART,USD,1,0,0,1,0,0,0
OTIS,SMART,USD,1,0,0,1,0,0,0
AZEK,SMART,USD,1,0,0,1,0,0,0
ALGM,SMART,USD,1,0,0,1,0,0,0
DASH,SMART,USD,1,0,0,1,0,0,0
YSG,SMART,USD,1,0,0,1,0,0,0
CNXC,SMART,USD,1,0,0,1,0,0,0
XM,SMART,USD,1,0,0,1,0,0,0
XPEV,SMART,USD,1,0,0,1,0,0,0
FROG,SMART,USD,1,0,0,1,0,0,0
CERT,SMART,USD,1,0,0,1,0,0,0
ACVA,SMART,USD,1,0,0,1,0,0,0
ALHC,SMART,USD,1,0,0,1,0,0,0
DSEY,SMART,USD,1,0,0,1,0,0,0
HAYW,SMART,USD,1,0,0,1,0,0,0
COIN,SMART,USD,1,0,0,1,0,0,0
COUR,SMART,USD,1,0,0,1,0,0,0
CPNG,SMART,USD,1,0,0,1,0,0,0
COMP,SMART,USD,1,0,0,1,0,0,0
BMBL,SMART,USD,1,0,0,1,0,0,0
DCT,SMART,USD,1,0,0,1,0,0,0
CMS,SMART,USD,0,0,0,0,0,0,0
PEP,SMART,USD,0,0,0,0,0,0,0
MSGS,SMART,USD,0,0,0,0,0,0,0
GE,SMART,USD,0,0,0,0,0,0,0
ALC,SMART,USD,0,0,0,0,0,0,0
NWE,SMART,USD,0,0,0,0,0,0,0
ZH,SMART,USD,0,0,0,0,0,0,0
RBLX,SMART,USD,0,0,0,0,0,0,0
PATH,SMART,USD,0,0,0,0,0,0,0
CHT,SMART,USD,0,0,0,0,0,0,0
LU,SMART,USD,0,0,0,0,0,0,0
FERG,SMART,USD,0,0,0,0,0,0,0
WMG,SMART,USD,0,0,0,0,0,0,0
UWMC,SMART,USD,0,0,0,0,0,0,0
AGL,SMART,USD,0,0,0,0,0,0,0
PLTK,SMART,USD,0,0,0,0,0,0,0
TSP,SMART,USD,0,0,0,0,0,0,0
TUYA,SMART,USD,0,0,0,0,0,0,0
CSAN,SMART,USD,0,0,0,0,0,0,0
SHC,SMART,USD,0,0,0,0,0,0,0
SGFY,SMART,USD,0,0,0,0,0,0,0
DV,SMART,USD,0,0,0,0,0,0,0
SHLS,SMART,USD,0,0,0,0,0,0,0
VNT,SMART,USD,0,0,0,0,0,0,0
OCDX,SMART,USD,0,0,0,0,0,0,0
DOCN,SMART,USD,0,0,0,0,0,0,0
ULCC,SMART,USD,0,0,0,0,0,0,0
CHK,SMART,USD,0,0,0,0,0,0,0
ATC,SMART,USD,0,0,0,0,0,0,0
OLO,SMART,USD,0,0,0,0,0,0,0
BHFAN,SMART,USD,0,0,0,0,0,0,0
ASAI,SMART,USD,0,0,0,0,0,0,0
PRVA,SMART,USD,0,0,0,0,0,0,0
MRVI,SMART,USD,0,0,0,0,0,0,0
INNV,SMART,USD,0,0,0,0,0,0,0
SWIM,SMART,USD,0,0,0,0,0,0,0
RLAY,SMART,USD,0,0,0,0,0,0,0