Symbol,Exchange,Currency,OPGs Found,Take Profit,Profit,StopLoss,Loss,Wins,%
LBTYB,SMART,USD,23,9,14,0,0,23,100
WSM,SMART,USD,11,11,0,0,0,11,100
AEL,SMART,USD,9,8,1,0,0,9,100
WWW,SMART,USD,9,8,1,0,0,9,100
COP,SMART,USD,9,6,3,0,0,9,100
GTES,SMART,USD,8,8,0,0,0,8,100
KW,SMART,USD,8,5,3,0,0,8,100
HAS,SMART,USD,8,5,3,0,0,8,100
HALO,SMART,USD,7,7,0,0,0,7,100
LILAK,SMART,USD,7,7,0,0,0,7,100
RCKT,SMART,USD,7,7,0,0,0,7,100
DCPH,SMART,USD,7,7,0,0,0,7,100
DOOR,SMART,USD,7,6,1,0,0,7,100
MASI,SMART,USD,7,6,1,0,0,7,100
NYT,SMART,USD,7,6,1,0,0,7,100
GILD,SMART,USD,7,4,3,0,0,7,100
AWR,SMART,USD,7,4,3,0,0,7,100
CHDN,SMART,USD,6,6,0,0,0,6,100
SONO,SMART,USD,6,6,0,0,0,6,100
AHCO,SMART,USD,6,6,0,0,0,6,100
LMND,SMART,USD,6,6,0,0,0,6,100
ANTM,SMART,USD,6,5,1,0,0,6,100
TRTN,SMART,USD,6,5,1,0,0,6,100
SJI,SMART,USD,6,4,2,0,0,6,100
H,SMART,USD,6,4,2,0,0,6,100
FNB,SMART,USD,6,3,3,0,0,6,100
HPQ,SMART,USD,6,2,4,0,0,6,100
COKE,SMART,USD,5,5,0,0,0,5,100
MEDP,SMART,USD,5,5,0,0,0,5,100
JKHY,SMART,USD,5,5,0,0,0,5,100
ANAT,SMART,USD,5,5,0,0,0,5,100
MDLA,SMART,USD,5,5,0,0,0,5,100
BBIO,SMART,USD,5,5,0,0,0,5,100
CGAU,SMART,USD,5,4,1,0,0,5,100
WMB,SMART,USD,5,4,1,0,0,5,100
CRL,SMART,USD,5,4,1,0,0,5,100
GLOB,SMART,USD,5,4,1,0,0,5,100
HUM,SMART,USD,5,4,1,0,0,5,100
THS,SMART,USD,5,4,1,0,0,5,100
MOS,SMART,USD,5,4,1,0,0,5,100
RGA,SMART,USD,5,4,1,0,0,5,100
TT,SMART,USD,5,4,1,0,0,5,100
PNW,SMART,USD,5,4,1,0,0,5,100
ACGL,SMART,USD,5,4,1,0,0,5,100
AVNT,SMART,USD,5,4,1,0,0,5,100
TTWO,SMART,USD,5,3,2,0,0,5,100
ROK,SMART,USD,5,3,2,0,0,5,100
FOX,SMART,USD,5,3,2,0,0,5,100
XRAY,SMART,USD,5,2,3,0,0,5,100
RARE,SMART,USD,15,14,0,1,0,14,93.33333333
RDFN,SMART,USD,14,13,0,1,0,13,92.85714286
JOBS,SMART,USD,14,12,1,1,0,13,92.85714286
IGT,SMART,USD,14,12,1,1,0,13,92.85714286
AYI,SMART,USD,13,11,1,0,1,12,92.30769231
HWM,SMART,USD,12,10,1,1,0,11,91.66666667
SABR,SMART,USD,12,9,2,1,0,11,91.66666667
RGEN,SMART,USD,11,9,1,1,0,10,90.90909091
AQUA,SMART,USD,11,9,1,1,0,10,90.90909091
ENBL,SMART,USD,11,8,2,1,0,10,90.90909091
ADS,SMART,USD,11,8,2,1,0,10,90.90909091
TWTR,SMART,USD,11,8,2,1,0,10,90.90909091
MCK,SMART,USD,11,7,3,1,0,10,90.90909091
SIRI,SMART,USD,11,7,3,1,0,10,90.90909091
NOVT,SMART,USD,10,9,0,1,0,9,90
EQT,SMART,USD,10,9,0,1,0,9,90
IQ,SMART,USD,10,9,0,1,0,9,90
IONS,SMART,USD,10,8,1,1,0,9,90
STX,SMART,USD,10,8,1,1,0,9,90
IR,SMART,USD,10,8,1,1,0,9,90
IEP,SMART,USD,10,8,1,1,0,9,90
SITE,SMART,USD,10,8,1,1,0,9,90
PZZA,SMART,USD,10,7,2,1,0,9,90
OC,SMART,USD,10,7,2,1,0,9,90
WPM,SMART,USD,10,7,2,1,0,9,90
CVS,SMART,USD,10,5,4,1,0,9,90
JNCE,SMART,USD,18,16,0,2,0,16,88.88888889
KMX,SMART,USD,9,8,0,1,0,8,88.88888889
KGC,SMART,USD,9,8,0,1,0,8,88.88888889
BEP,SMART,USD,9,8,0,1,0,8,88.88888889
VG,SMART,USD,9,8,0,1,0,8,88.88888889
BL,SMART,USD,9,8,0,1,0,8,88.88888889
IMO,SMART,USD,9,8,0,1,0,8,88.88888889
ARVN,SMART,USD,9,8,0,1,0,8,88.88888889
AVAV,SMART,USD,9,7,1,1,0,8,88.88888889
SSO,SMART,USD,9,6,2,1,0,8,88.88888889
FOXA,SMART,USD,9,6,2,1,0,8,88.88888889
GIL,SMART,USD,9,5,3,1,0,8,88.88888889
CARG,SMART,USD,8,7,0,1,0,7,87.5
QLYS,SMART,USD,8,7,0,1,0,7,87.5
MRNA,SMART,USD,8,7,0,1,0,7,87.5
PTON,SMART,USD,8,7,0,1,0,7,87.5
NKLA,SMART,USD,8,7,0,1,0,7,87.5
SLM,SMART,USD,8,6,1,1,0,7,87.5
BOKF,SMART,USD,8,6,1,1,0,7,87.5
HAIN,SMART,USD,8,6,1,1,0,7,87.5
EC,SMART,USD,8,6,1,1,0,7,87.5
BKU,SMART,USD,8,5,2,1,0,7,87.5
PAG,SMART,USD,8,5,2,1,0,7,87.5
RHI,SMART,USD,8,4,3,0,1,7,87.5
WDFC,SMART,USD,8,4,3,1,0,7,87.5
NLOK,SMART,USD,8,4,3,1,0,7,87.5
ABBV,SMART,USD,8,4,3,1,0,7,87.5
CFX,SMART,USD,8,3,4,1,0,7,87.5
ONB,SMART,USD,8,3,4,1,0,7,87.5
CALX,SMART,USD,15,12,1,2,0,13,86.66666667
NUS,SMART,USD,15,11,2,1,1,13,86.66666667
ZG,SMART,USD,14,11,1,2,0,12,85.71428571
PENN,SMART,USD,14,9,3,2,0,12,85.71428571
WHR,SMART,USD,7,6,0,0,1,6,85.71428571
TDS,SMART,USD,7,6,0,0,1,6,85.71428571
MA,SMART,USD,7,6,0,0,1,6,85.71428571
NOV,SMART,USD,7,6,0,1,0,6,85.71428571
SYF,SMART,USD,7,6,0,1,0,6,85.71428571
ALRM,SMART,USD,7,6,0,1,0,6,85.71428571
HLT,SMART,USD,7,6,0,1,0,6,85.71428571
PRMW,SMART,USD,7,6,0,1,0,6,85.71428571
IBP,SMART,USD,7,6,0,1,0,6,85.71428571
MSI,SMART,USD,7,6,0,1,0,6,85.71428571
VEEV,SMART,USD,7,6,0,1,0,6,85.71428571
TRU,SMART,USD,7,6,0,1,0,6,85.71428571
MGM,SMART,USD,7,6,0,1,0,6,85.71428571
PDD,SMART,USD,7,6,0,1,0,6,85.71428571
HCA,SMART,USD,7,6,0,1,0,6,85.71428571
CHNG,SMART,USD,7,6,0,1,0,6,85.71428571
CHPT,SMART,USD,7,6,0,1,0,6,85.71428571
MAR,SMART,USD,7,5,1,0,1,6,85.71428571
ITRI,SMART,USD,7,5,1,0,1,6,85.71428571
ZION,SMART,USD,7,5,1,1,0,6,85.71428571
WRK,SMART,USD,7,5,1,1,0,6,85.71428571
CNC,SMART,USD,7,5,1,1,0,6,85.71428571
SC,SMART,USD,7,5,1,1,0,6,85.71428571
TCBI,SMART,USD,7,5,1,1,0,6,85.71428571
DOCU,SMART,USD,7,5,1,1,0,6,85.71428571
CWEN,SMART,USD,7,5,1,1,0,6,85.71428571
DM,SMART,USD,7,5,1,1,0,6,85.71428571
CPB,SMART,USD,7,4,2,0,1,6,85.71428571
CCOI,SMART,USD,7,4,2,1,0,6,85.71428571
MATX,SMART,USD,7,4,2,1,0,6,85.71428571
MTZ,SMART,USD,7,4,2,1,0,6,85.71428571
KMI,SMART,USD,7,3,3,1,0,6,85.71428571
CLGX,SMART,USD,7,3,3,1,0,6,85.71428571
BRKR,SMART,USD,7,3,3,1,0,6,85.71428571
VRSK,SMART,USD,7,3,3,1,0,6,85.71428571
FDS,SMART,USD,7,3,3,1,0,6,85.71428571
AAON,SMART,USD,7,2,4,1,0,6,85.71428571
UNM,SMART,USD,7,2,4,1,0,6,85.71428571
RCM,SMART,USD,13,11,0,1,1,11,84.61538462
HUBS,SMART,USD,13,11,0,2,0,11,84.61538462
AU,SMART,USD,13,11,0,2,0,11,84.61538462
SQ,SMART,USD,13,10,1,2,0,11,84.61538462
AM,SMART,USD,13,10,1,2,0,11,84.61538462
FLEX,SMART,USD,13,9,2,2,0,11,84.61538462
ARWR,SMART,USD,18,15,0,3,0,15,83.33333333
SPWR,SMART,USD,18,15,0,3,0,15,83.33333333
HL,SMART,USD,12,10,0,2,0,10,83.33333333
SWAV,SMART,USD,12,10,0,2,0,10,83.33333333
ROCK,SMART,USD,12,9,1,2,0,10,83.33333333
WYNN,SMART,USD,12,9,1,2,0,10,83.33333333
MBT,SMART,USD,12,8,2,2,0,10,83.33333333
WEX,SMART,USD,12,7,3,1,1,10,83.33333333
HOLX,SMART,USD,12,6,4,2,0,10,83.33333333
CBRE,SMART,USD,6,5,0,1,0,5,83.33333333
LEA,SMART,USD,6,5,0,1,0,5,83.33333333
CPA,SMART,USD,6,5,0,1,0,5,83.33333333
UNP,SMART,USD,6,5,0,1,0,5,83.33333333
GDDY,SMART,USD,6,5,0,1,0,5,83.33333333
STAA,SMART,USD,6,5,0,1,0,5,83.33333333
AON,SMART,USD,6,5,0,1,0,5,83.33333333
ALTR,SMART,USD,6,5,0,1,0,5,83.33333333
ZLAB,SMART,USD,6,5,0,1,0,5,83.33333333
USFD,SMART,USD,6,5,0,1,0,5,83.33333333
F,SMART,USD,6,5,0,1,0,5,83.33333333
TWST,SMART,USD,6,5,0,1,0,5,83.33333333
ELAN,SMART,USD,6,5,0,1,0,5,83.33333333
NSP,SMART,USD,6,5,0,1,0,5,83.33333333
BPY,SMART,USD,6,5,0,1,0,5,83.33333333
ESTC,SMART,USD,6,5,0,1,0,5,83.33333333
LYFT,SMART,USD,6,5,0,1,0,5,83.33333333
ZM,SMART,USD,6,5,0,1,0,5,83.33333333
IHRT,SMART,USD,6,5,0,1,0,5,83.33333333
SPT,SMART,USD,6,5,0,1,0,5,83.33333333
CHWY,SMART,USD,6,5,0,1,0,5,83.33333333
FTV,SMART,USD,6,4,1,0,1,5,83.33333333
FSV,SMART,USD,6,4,1,0,1,5,83.33333333
SNN,SMART,USD,6,4,1,0,1,5,83.33333333
FE,SMART,USD,6,4,1,1,0,5,83.33333333
INCY,SMART,USD,6,4,1,1,0,5,83.33333333
ITGR,SMART,USD,6,4,1,1,0,5,83.33333333
AAPL,SMART,USD,6,4,1,1,0,5,83.33333333
AJRD,SMART,USD,6,4,1,1,0,5,83.33333333
CAT,SMART,USD,6,4,1,1,0,5,83.33333333
Y,SMART,USD,6,4,1,1,0,5,83.33333333
SYY,SMART,USD,6,4,1,1,0,5,83.33333333
VSH,SMART,USD,6,4,1,1,0,5,83.33333333
EW,SMART,USD,6,4,1,1,0,5,83.33333333
LNC,SMART,USD,6,4,1,1,0,5,83.33333333
NYCB,SMART,USD,6,4,1,1,0,5,83.33333333
ALLE,SMART,USD,6,4,1,1,0,5,83.33333333
CACI,SMART,USD,6,3,2,0,1,5,83.33333333
SR,SMART,USD,6,3,2,0,1,5,83.33333333
FFIN,SMART,USD,6,3,2,1,0,5,83.33333333
WTRG,SMART,USD,6,3,2,1,0,5,83.33333333
FWONA,SMART,USD,6,3,2,1,0,5,83.33333333
BCC,SMART,USD,6,3,2,1,0,5,83.33333333
RELX,SMART,USD,6,3,2,1,0,5,83.33333333
UHS,SMART,USD,6,3,2,1,0,5,83.33333333
MET,SMART,USD,6,3,2,1,0,5,83.33333333
ADP,SMART,USD,6,3,2,1,0,5,83.33333333
SCI,SMART,USD,6,3,2,1,0,5,83.33333333
HAE,SMART,USD,6,3,2,1,0,5,83.33333333
ADV,SMART,USD,6,1,4,1,0,5,83.33333333
TGTX,SMART,USD,17,14,0,3,0,14,82.35294118
SIG,SMART,USD,17,13,1,3,0,14,82.35294118
AMRS,SMART,USD,28,23,0,5,0,23,82.14285714
MAXR,SMART,USD,22,15,3,4,0,18,81.81818182
MIME,SMART,USD,11,9,0,2,0,9,81.81818182
RH,SMART,USD,11,9,0,2,0,9,81.81818182
IPGP,SMART,USD,11,9,0,2,0,9,81.81818182
OLLI,SMART,USD,11,8,1,0,2,9,81.81818182
BKNG,SMART,USD,11,8,1,1,1,9,81.81818182
BIIB,SMART,USD,11,8,1,2,0,9,81.81818182
PPBI,SMART,USD,11,8,1,2,0,9,81.81818182
WBT,SMART,USD,11,8,1,2,0,9,81.81818182
PEN,SMART,USD,11,7,2,2,0,9,81.81818182
QRTEA,SMART,USD,11,7,2,2,0,9,81.81818182
WD,SMART,USD,11,6,3,2,0,9,81.81818182
HRB,SMART,USD,11,5,4,2,0,9,81.81818182
NTRA,SMART,USD,16,12,1,3,0,13,81.25
RCII,SMART,USD,16,12,1,3,0,13,81.25
ADNT,SMART,USD,16,12,1,3,0,13,81.25
APA,SMART,USD,16,12,1,3,0,13,81.25
NWG,SMART,USD,16,10,3,3,0,13,81.25
TNDM,SMART,USD,21,17,0,4,0,17,80.95238095
LTRPB,SMART,USD,26,11,10,4,1,21,80.76923077
IBRX,SMART,USD,25,20,0,5,0,20,80
DISCB,SMART,USD,25,15,5,5,0,20,80
W,SMART,USD,15,12,0,2,1,12,80
PTCT,SMART,USD,15,12,0,3,0,12,80
SRPT,SMART,USD,15,12,0,3,0,12,80
BOX,SMART,USD,10,8,0,2,0,8,80
BPMC,SMART,USD,10,8,0,2,0,8,80
BGNE,SMART,USD,10,8,0,2,0,8,80
DISH,SMART,USD,10,8,0,2,0,8,80
FWONK,SMART,USD,10,8,0,2,0,8,80
LITE,SMART,USD,10,8,0,2,0,8,80
BYD,SMART,USD,10,8,0,2,0,8,80
CNX,SMART,USD,10,8,0,2,0,8,80
BLMN,SMART,USD,10,8,0,2,0,8,80
FN,SMART,USD,10,7,1,1,1,8,80
A,SMART,USD,10,7,1,1,1,8,80
UA,SMART,USD,10,7,1,2,0,8,80
MKTX,SMART,USD,10,7,1,2,0,8,80
APO,SMART,USD,10,7,1,2,0,8,80
TKR,SMART,USD,10,6,2,1,1,8,80
MOH,SMART,USD,10,6,2,1,1,8,80
ENSG,SMART,USD,10,6,2,2,0,8,80
VLO,SMART,USD,10,6,2,2,0,8,80
NWL,SMART,USD,10,6,2,2,0,8,80
CIB,SMART,USD,10,5,3,2,0,8,80
FTNT,SMART,USD,10,5,3,2,0,8,80
BKI,SMART,USD,10,4,4,2,0,8,80
SNA,SMART,USD,5,4,0,0,1,4,80
UTHR,SMART,USD,5,4,0,1,0,4,80
ODFL,SMART,USD,5,4,0,1,0,4,80
CFG,SMART,USD,5,4,0,1,0,4,80
UHAL,SMART,USD,5,4,0,1,0,4,80
CAH,SMART,USD,5,4,0,1,0,4,80
MAS,SMART,USD,5,4,0,1,0,4,80
DPZ,SMART,USD,5,4,0,1,0,4,80
TRV,SMART,USD,5,4,0,1,0,4,80
SE,SMART,USD,5,4,0,1,0,4,80
LEN,SMART,USD,5,4,0,1,0,4,80
AJG,SMART,USD,5,4,0,1,0,4,80
EAF,SMART,USD,5,4,0,1,0,4,80
DRI,SMART,USD,5,4,0,1,0,4,80
MKL,SMART,USD,5,4,0,1,0,4,80
ASR,SMART,USD,5,4,0,1,0,4,80
ATH,SMART,USD,5,4,0,1,0,4,80
ESGR,SMART,USD,5,4,0,1,0,4,80
NOVA,SMART,USD,5,4,0,1,0,4,80
PD,SMART,USD,5,4,0,1,0,4,80
SWTX,SMART,USD,5,4,0,1,0,4,80
EQNR,SMART,USD,5,4,0,1,0,4,80
ROOT,SMART,USD,5,4,0,1,0,4,80
SKLZ,SMART,USD,5,4,0,1,0,4,80
JCI,SMART,USD,5,3,1,1,0,4,80
CTSH,SMART,USD,5,3,1,1,0,4,80
WTFC,SMART,USD,5,3,1,1,0,4,80
NDAQ,SMART,USD,5,3,1,1,0,4,80
PB,SMART,USD,5,3,1,1,0,4,80
SMPL,SMART,USD,5,3,1,1,0,4,80
VMI,SMART,USD,5,3,1,1,0,4,80
AN,SMART,USD,5,3,1,1,0,4,80
SYK,SMART,USD,5,3,1,1,0,4,80
L,SMART,USD,5,3,1,1,0,4,80
SMG,SMART,USD,5,3,1,1,0,4,80
FAF,SMART,USD,5,3,1,1,0,4,80
CW,SMART,USD,5,3,1,1,0,4,80
LKQ,SMART,USD,5,3,1,1,0,4,80
FAST,SMART,USD,5,3,1,1,0,4,80
CVLT,SMART,USD,5,3,1,1,0,4,80
FFIV,SMART,USD,5,3,1,1,0,4,80
UAL,SMART,USD,5,3,1,1,0,4,80
RF,SMART,USD,5,3,1,1,0,4,80
FHB,SMART,USD,5,3,1,1,0,4,80
DOW,SMART,USD,5,3,1,1,0,4,80
BAH,SMART,USD,5,3,1,1,0,4,80
VRTX,SMART,USD,5,2,2,0,1,4,80
ALXN,SMART,USD,5,2,2,1,0,4,80
TSEM,SMART,USD,5,2,2,1,0,4,80
IART,SMART,USD,5,2,2,1,0,4,80
COLM,SMART,USD,5,2,2,1,0,4,80
TDY,SMART,USD,5,2,2,1,0,4,80
PFG,SMART,USD,5,2,2,1,0,4,80
V,SMART,USD,5,2,2,1,0,4,80
OZK,SMART,USD,5,2,2,1,0,4,80
BXS,SMART,USD,5,2,2,1,0,4,80
TFC,SMART,USD,5,2,2,1,0,4,80
HLI,SMART,USD,5,1,3,0,1,4,80
JBHT,SMART,USD,5,1,3,1,0,4,80
SFIX,SMART,USD,19,15,0,4,0,15,78.94736842
PSTG,SMART,USD,19,13,2,4,0,15,78.94736842
PAC,SMART,USD,19,12,3,3,1,15,78.94736842
TDOC,SMART,USD,14,11,0,3,0,11,78.57142857
APPN,SMART,USD,14,11,0,3,0,11,78.57142857
MMYT,SMART,USD,14,10,1,3,0,11,78.57142857
AER,SMART,USD,14,10,1,3,0,11,78.57142857
FSLR,SMART,USD,14,9,2,2,1,11,78.57142857
UGP,SMART,USD,18,14,0,4,0,14,77.77777778
NEO,SMART,USD,9,7,0,2,0,7,77.77777778
MEOH,SMART,USD,9,7,0,2,0,7,77.77777778
ACHC,SMART,USD,9,7,0,2,0,7,77.77777778
AMN,SMART,USD,9,7,0,2,0,7,77.77777778
IBTX,SMART,USD,9,7,0,2,0,7,77.77777778
OMF,SMART,USD,9,7,0,2,0,7,77.77777778
IQV,SMART,USD,9,7,0,2,0,7,77.77777778
TGNA,SMART,USD,9,7,0,2,0,7,77.77777778
DKS,SMART,USD,9,7,0,2,0,7,77.77777778
MTH,SMART,USD,9,6,1,1,1,7,77.77777778
LNG,SMART,USD,9,6,1,1,1,7,77.77777778
LILA,SMART,USD,9,6,1,1,1,7,77.77777778
PODD,SMART,USD,9,6,1,2,0,7,77.77777778
URI,SMART,USD,9,6,1,2,0,7,77.77777778
FIVN,SMART,USD,9,6,1,2,0,7,77.77777778
EBS,SMART,USD,9,6,1,2,0,7,77.77777778
PAAS,SMART,USD,9,6,1,2,0,7,77.77777778
POWI,SMART,USD,9,6,1,2,0,7,77.77777778
BECN,SMART,USD,9,6,1,2,0,7,77.77777778
WAB,SMART,USD,9,6,1,2,0,7,77.77777778
SPB,SMART,USD,9,6,1,2,0,7,77.77777778
REGN,SMART,USD,9,5,2,2,0,7,77.77777778
SHLX,SMART,USD,9,5,2,2,0,7,77.77777778
AEIS,SMART,USD,9,5,2,2,0,7,77.77777778
SYNH,SMART,USD,9,5,2,2,0,7,77.77777778
TFX,SMART,USD,9,5,2,2,0,7,77.77777778
FCNCA,SMART,USD,9,5,2,2,0,7,77.77777778
TEF,SMART,USD,9,4,3,1,1,7,77.77777778
AL,SMART,USD,9,4,3,2,0,7,77.77777778
PACB,SMART,USD,22,17,0,5,0,17,77.27272727
SEDG,SMART,USD,13,10,0,3,0,10,76.92307692
VCYT,SMART,USD,13,10,0,3,0,10,76.92307692
DXC,SMART,USD,13,10,0,3,0,10,76.92307692
CAR,SMART,USD,13,9,1,2,1,10,76.92307692
YELP,SMART,USD,13,9,1,3,0,10,76.92307692
EXEL,SMART,USD,13,7,3,2,1,10,76.92307692
CAE,SMART,USD,13,7,3,2,1,10,76.92307692
LUMN,SMART,USD,13,6,4,1,2,10,76.92307692
NIO,SMART,USD,17,13,0,4,0,13,76.47058824
FUBO,SMART,USD,29,18,4,7,0,22,75.86206897
TFII,SMART,USD,24,9,9,5,1,18,75
NVCR,SMART,USD,20,14,1,4,1,15,75
CLR,SMART,USD,16,12,0,4,0,12,75
Z,SMART,USD,16,11,1,4,0,12,75
PRLB,SMART,USD,12,9,0,2,1,9,75
NVTA,SMART,USD,12,9,0,3,0,9,75
CZR,SMART,USD,12,9,0,3,0,9,75
COUP,SMART,USD,12,9,0,3,0,9,75
TDG,SMART,USD,12,8,1,1,2,9,75
MU,SMART,USD,12,8,1,2,1,9,75
HES,SMART,USD,12,8,1,3,0,9,75
ELY,SMART,USD,12,7,2,1,2,9,75
CCL,SMART,USD,12,7,2,2,1,9,75
ESI,SMART,USD,12,7,2,3,0,9,75
MPLX,SMART,USD,12,7,2,3,0,9,75
PSO,SMART,USD,12,6,3,1,2,9,75
AKAM,SMART,USD,12,4,5,2,1,9,75
MRVL,SMART,USD,8,6,0,0,2,6,75
KBH,SMART,USD,8,6,0,1,1,6,75
EGHT,SMART,USD,8,6,0,1,1,6,75
ANET,SMART,USD,8,6,0,1,1,6,75
DECK,SMART,USD,8,6,0,2,0,6,75
SAVE,SMART,USD,8,6,0,2,0,6,75
FBP,SMART,USD,8,6,0,2,0,6,75
PUK,SMART,USD,8,6,0,2,0,6,75
BLDR,SMART,USD,8,6,0,2,0,6,75
SQM,SMART,USD,8,6,0,2,0,6,75
NWSA,SMART,USD,8,6,0,2,0,6,75
KBR,SMART,USD,8,6,0,2,0,6,75
SLB,SMART,USD,8,6,0,2,0,6,75
ARW,SMART,USD,8,6,0,2,0,6,75
TENB,SMART,USD,8,6,0,2,0,6,75
COHR,SMART,USD,8,6,0,2,0,6,75
QFIN,SMART,USD,8,6,0,2,0,6,75
LTHM,SMART,USD,8,6,0,2,0,6,75
PINS,SMART,USD,8,6,0,2,0,6,75
VIR,SMART,USD,8,6,0,2,0,6,75
PLAN,SMART,USD,8,6,0,2,0,6,75
JAZZ,SMART,USD,8,5,1,1,1,6,75
LGIH,SMART,USD,8,5,1,1,1,6,75
BBD,SMART,USD,8,5,1,2,0,6,75
XRX,SMART,USD,8,5,1,2,0,6,75
AGCO,SMART,USD,8,5,1,2,0,6,75
AAL,SMART,USD,8,5,1,2,0,6,75
PRU,SMART,USD,8,5,1,2,0,6,75
KKR,SMART,USD,8,5,1,2,0,6,75
SWI,SMART,USD,8,5,1,2,0,6,75
VIAC,SMART,USD,8,5,1,2,0,6,75
ON,SMART,USD,8,4,2,1,1,6,75
EPD,SMART,USD,8,4,2,1,1,6,75
PNM,SMART,USD,8,4,2,2,0,6,75
SPGI,SMART,USD,8,4,2,2,0,6,75
HLF,SMART,USD,8,4,2,2,0,6,75
ICL,SMART,USD,8,3,3,2,0,6,75
NKTR,SMART,USD,19,14,0,5,0,14,73.68421053
SUZ,SMART,USD,19,7,7,5,0,14,73.68421053
PAA,SMART,USD,15,11,0,3,1,11,73.33333333
IOVA,SMART,USD,15,11,0,4,0,11,73.33333333
AGIO,SMART,USD,15,11,0,4,0,11,73.33333333
GSX,SMART,USD,15,11,0,4,0,11,73.33333333
JMIA,SMART,USD,15,11,0,4,0,11,73.33333333
ETSY,SMART,USD,15,10,1,4,0,11,73.33333333
BHVN,SMART,USD,15,10,1,4,0,11,73.33333333
CDLX,SMART,USD,15,10,1,4,0,11,73.33333333
TV,SMART,USD,15,6,5,3,1,11,73.33333333
HEI,SMART,USD,11,8,0,2,1,8,72.72727273
BILI,SMART,USD,11,8,0,3,0,8,72.72727273
SMAR,SMART,USD,11,8,0,3,0,8,72.72727273
ZS,SMART,USD,11,8,0,3,0,8,72.72727273
TMHC,SMART,USD,11,7,1,2,1,8,72.72727273
TRN,SMART,USD,11,7,1,2,1,8,72.72727273
OLN,SMART,USD,11,7,1,3,0,8,72.72727273
ETRN,SMART,USD,11,7,1,3,0,8,72.72727273
OMCL,SMART,USD,11,6,2,3,0,8,72.72727273
SCCO,SMART,USD,11,6,2,3,0,8,72.72727273
SIX,SMART,USD,11,6,2,3,0,8,72.72727273
KEP,SMART,USD,11,5,3,2,1,8,72.72727273
CWST,SMART,USD,11,5,3,3,0,8,72.72727273
KB,SMART,USD,11,5,3,3,0,8,72.72727273
BIDU,SMART,USD,11,5,3,3,0,8,72.72727273
DSGX,SMART,USD,11,4,4,1,2,8,72.72727273
NMR,SMART,USD,11,4,4,3,0,8,72.72727273
OSTK,SMART,USD,29,21,0,8,0,21,72.4137931
SID,SMART,USD,18,13,0,5,0,13,72.22222222
QRTEB,SMART,USD,28,11,9,6,2,20,71.42857143
THC,SMART,USD,21,15,0,6,0,15,71.42857143
VCEL,SMART,USD,14,10,0,4,0,10,71.42857143
BHC,SMART,USD,14,10,0,4,0,10,71.42857143
JD,SMART,USD,14,10,0,4,0,10,71.42857143
IRDM,SMART,USD,14,10,0,4,0,10,71.42857143
AYX,SMART,USD,14,10,0,4,0,10,71.42857143
ARGX,SMART,USD,14,10,0,4,0,10,71.42857143
THO,SMART,USD,14,9,1,4,0,10,71.42857143
EOG,SMART,USD,14,8,2,4,0,10,71.42857143
LYG,SMART,USD,14,7,3,2,2,10,71.42857143
ATRC,SMART,USD,14,7,3,3,1,10,71.42857143
GTLS,SMART,USD,14,7,3,4,0,10,71.42857143
ATKR,SMART,USD,14,7,3,4,0,10,71.42857143
PRAH,SMART,USD,7,5,0,0,2,5,71.42857143
RXN,SMART,USD,7,5,0,1,1,5,71.42857143
RPM,SMART,USD,7,5,0,1,1,5,71.42857143
ESNT,SMART,USD,7,5,0,1,1,5,71.42857143
SUM,SMART,USD,7,5,0,1,1,5,71.42857143
BJ,SMART,USD,7,5,0,1,1,5,71.42857143
BTG,SMART,USD,7,5,0,2,0,5,71.42857143
ILMN,SMART,USD,7,5,0,2,0,5,71.42857143
NBIX,SMART,USD,7,5,0,2,0,5,71.42857143
ARNA,SMART,USD,7,5,0,2,0,5,71.42857143
TPH,SMART,USD,7,5,0,2,0,5,71.42857143
SFNC,SMART,USD,7,5,0,2,0,5,71.42857143
EYE,SMART,USD,7,5,0,2,0,5,71.42857143
TAP,SMART,USD,7,5,0,2,0,5,71.42857143
CNMD,SMART,USD,7,5,0,2,0,5,71.42857143
TCF,SMART,USD,7,5,0,2,0,5,71.42857143
BWXT,SMART,USD,7,5,0,2,0,5,71.42857143
KTB,SMART,USD,7,5,0,2,0,5,71.42857143
DOYU,SMART,USD,7,5,0,2,0,5,71.42857143
RVLV,SMART,USD,7,5,0,2,0,5,71.42857143
TME,SMART,USD,7,5,0,2,0,5,71.42857143
FSLY,SMART,USD,7,5,0,2,0,5,71.42857143
KRTX,SMART,USD,7,5,0,2,0,5,71.42857143
OCFT,SMART,USD,7,5,0,2,0,5,71.42857143
JOE,SMART,USD,7,4,1,1,1,5,71.42857143
NUE,SMART,USD,7,4,1,1,1,5,71.42857143
AMZN,SMART,USD,7,4,1,1,1,5,71.42857143
JCOM,SMART,USD,7,4,1,1,1,5,71.42857143
BMI,SMART,USD,7,4,1,1,1,5,71.42857143
IP,SMART,USD,7,4,1,1,1,5,71.42857143
BA,SMART,USD,7,4,1,1,1,5,71.42857143
FRPT,SMART,USD,7,4,1,2,0,5,71.42857143
EXPE,SMART,USD,7,4,1,2,0,5,71.42857143
AMBA,SMART,USD,7,4,1,2,0,5,71.42857143
BC,SMART,USD,7,4,1,2,0,5,71.42857143
FHI,SMART,USD,7,4,1,2,0,5,71.42857143
PCRX,SMART,USD,7,4,1,2,0,5,71.42857143
VOYA,SMART,USD,7,4,1,2,0,5,71.42857143
CWT,SMART,USD,7,4,1,2,0,5,71.42857143
FOXF,SMART,USD,7,4,1,2,0,5,71.42857143
AB,SMART,USD,7,4,1,2,0,5,71.42857143
KMT,SMART,USD,7,4,1,2,0,5,71.42857143
AMAT,SMART,USD,7,4,1,2,0,5,71.42857143
TS,SMART,USD,7,3,2,1,1,5,71.42857143
ETN,SMART,USD,7,3,2,1,1,5,71.42857143
NATI,SMART,USD,7,3,2,2,0,5,71.42857143
CTB,SMART,USD,7,3,2,2,0,5,71.42857143
ABM,SMART,USD,7,3,2,2,0,5,71.42857143
ROL,SMART,USD,7,2,3,2,0,5,71.42857143
LUV,SMART,USD,7,2,3,2,0,5,71.42857143
CDNA,SMART,USD,24,17,0,7,0,17,70.83333333
RIOT,SMART,USD,34,24,0,10,0,24,70.58823529
SGRY,SMART,USD,17,12,0,5,0,12,70.58823529
ATCO,SMART,USD,17,12,0,5,0,12,70.58823529
CRSP,SMART,USD,17,12,0,5,0,12,70.58823529
TWLO,SMART,USD,17,11,1,5,0,12,70.58823529
MRTX,SMART,USD,30,21,0,9,0,21,70
RUN,SMART,USD,20,14,0,6,0,14,70
PVH,SMART,USD,10,7,0,2,1,7,70
QDEL,SMART,USD,10,7,0,2,1,7,70
CIGI,SMART,USD,10,7,0,2,1,7,70
ATHM,SMART,USD,10,7,0,3,0,7,70
XLRN,SMART,USD,10,7,0,3,0,7,70
AMX,SMART,USD,10,7,0,3,0,7,70
WMS,SMART,USD,10,7,0,3,0,7,70
CRON,SMART,USD,10,7,0,3,0,7,70
CHX,SMART,USD,10,7,0,3,0,7,70
ALLK,SMART,USD,10,7,0,3,0,7,70
YETI,SMART,USD,10,7,0,3,0,7,70
NFE,SMART,USD,10,7,0,3,0,7,70
REZI,SMART,USD,10,7,0,3,0,7,70
CIT,SMART,USD,10,6,1,1,2,7,70
COMM,SMART,USD,10,6,1,2,1,7,70
HBAN,SMART,USD,10,6,1,3,0,7,70
DXCM,SMART,USD,10,6,1,3,0,7,70
CRS,SMART,USD,10,6,1,3,0,7,70
ENS,SMART,USD,10,5,2,3,0,7,70
IX,SMART,USD,10,5,2,3,0,7,70
ALV,SMART,USD,10,5,2,3,0,7,70
AAP,SMART,USD,10,5,2,3,0,7,70
CBT,SMART,USD,10,4,3,3,0,7,70
AIMC,SMART,USD,10,4,3,3,0,7,70
PPC,SMART,USD,10,4,3,3,0,7,70
DQ,SMART,USD,23,15,1,7,0,16,69.56521739
MXL,SMART,USD,13,9,0,3,1,9,69.23076923
AMRC,SMART,USD,13,9,0,3,1,9,69.23076923
RETA,SMART,USD,13,9,0,4,0,9,69.23076923
OMI,SMART,USD,13,8,1,4,0,9,69.23076923
R,SMART,USD,13,8,1,4,0,9,69.23076923
HP,SMART,USD,13,8,1,4,0,9,69.23076923
CACC,SMART,USD,13,7,2,2,2,9,69.23076923
FL,SMART,USD,13,6,3,4,0,9,69.23076923
PDCE,SMART,USD,16,11,0,5,0,11,68.75
CVNA,SMART,USD,16,11,0,5,0,11,68.75
ADT,SMART,USD,16,11,0,5,0,11,68.75
EBR,SMART,USD,16,10,1,5,0,11,68.75
CPRI,SMART,USD,16,10,1,5,0,11,68.75
COTY,SMART,USD,19,13,0,6,0,13,68.42105263
ORGO,SMART,USD,19,11,2,5,1,13,68.42105263
TRIP,SMART,USD,19,10,3,5,1,13,68.42105263
X,SMART,USD,22,15,0,7,0,15,68.18181818
ENPH,SMART,USD,25,17,0,8,0,17,68
CELH,SMART,USD,25,16,1,8,0,17,68
MARA,SMART,USD,34,23,0,11,0,23,67.64705882
GME,SMART,USD,18,12,0,6,0,12,66.66666667
PCG,SMART,USD,18,11,1,6,0,12,66.66666667
CLDR,SMART,USD,15,10,0,5,0,10,66.66666667
CHGG,SMART,USD,15,9,1,5,0,10,66.66666667
NGVT,SMART,USD,12,8,0,3,1,8,66.66666667
INSM,SMART,USD,12,8,0,4,0,8,66.66666667
TECK,SMART,USD,12,8,0,4,0,8,66.66666667
AEO,SMART,USD,12,8,0,4,0,8,66.66666667
MDB,SMART,USD,12,8,0,4,0,8,66.66666667
MED,SMART,USD,12,8,0,4,0,8,66.66666667
CUK,SMART,USD,12,7,1,1,3,8,66.66666667
DISCA,SMART,USD,12,7,1,3,1,8,66.66666667
CCXI,SMART,USD,12,7,1,4,0,8,66.66666667
HWC,SMART,USD,12,7,1,4,0,8,66.66666667
MRCY,SMART,USD,12,7,1,4,0,8,66.66666667
ENTG,SMART,USD,12,7,1,4,0,8,66.66666667
HGV,SMART,USD,12,7,1,4,0,8,66.66666667
VSAT,SMART,USD,12,6,2,3,1,8,66.66666667
LAZ,SMART,USD,12,6,2,4,0,8,66.66666667
TRMB,SMART,USD,9,6,0,1,2,6,66.66666667
BBVA,SMART,USD,9,6,0,2,1,6,66.66666667
ING,SMART,USD,9,6,0,2,1,6,66.66666667
MELI,SMART,USD,9,6,0,2,1,6,66.66666667
MTCH,SMART,USD,9,6,0,2,1,6,66.66666667
NRG,SMART,USD,9,6,0,3,0,6,66.66666667
ACAD,SMART,USD,9,6,0,3,0,6,66.66666667
ZEN,SMART,USD,9,6,0,3,0,6,66.66666667
NTNX,SMART,USD,9,6,0,3,0,6,66.66666667
JELD,SMART,USD,9,6,0,3,0,6,66.66666667
NVT,SMART,USD,9,6,0,3,0,6,66.66666667
CGC,SMART,USD,9,6,0,3,0,6,66.66666667
ALLO,SMART,USD,9,6,0,3,0,6,66.66666667
TDC,SMART,USD,9,5,1,1,2,6,66.66666667
PH,SMART,USD,9,5,1,3,0,6,66.66666667
BWA,SMART,USD,9,5,1,3,0,6,66.66666667
SSRM,SMART,USD,9,5,1,3,0,6,66.66666667
OKE,SMART,USD,9,5,1,3,0,6,66.66666667
NWS,SMART,USD,9,5,1,3,0,6,66.66666667
TRUP,SMART,USD,9,5,1,3,0,6,66.66666667
PXD,SMART,USD,9,5,1,3,0,6,66.66666667
BBY,SMART,USD,9,5,1,3,0,6,66.66666667
CNHI,SMART,USD,9,4,2,2,1,6,66.66666667
XOM,SMART,USD,9,4,2,2,1,6,66.66666667
NTAP,SMART,USD,9,4,2,3,0,6,66.66666667
GDS,SMART,USD,9,4,2,3,0,6,66.66666667
AXTA,SMART,USD,9,4,2,3,0,6,66.66666667
PACW,SMART,USD,9,4,2,3,0,6,66.66666667
CS,SMART,USD,9,3,3,3,0,6,66.66666667
NUVA,SMART,USD,9,3,3,3,0,6,66.66666667
HPE,SMART,USD,9,2,4,3,0,6,66.66666667
ULTA,SMART,USD,6,4,0,1,1,4,66.66666667
YNDX,SMART,USD,6,4,0,2,0,4,66.66666667
JLL,SMART,USD,6,4,0,2,0,4,66.66666667
IVZ,SMART,USD,6,4,0,2,0,4,66.66666667
HTH,SMART,USD,6,4,0,2,0,4,66.66666667
MMC,SMART,USD,6,4,0,2,0,4,66.66666667
ALGT,SMART,USD,6,4,0,2,0,4,66.66666667
ASGN,SMART,USD,6,4,0,2,0,4,66.66666667
CMCSA,SMART,USD,6,4,0,2,0,4,66.66666667
GNRC,SMART,USD,6,4,0,2,0,4,66.66666667
MSM,SMART,USD,6,4,0,2,0,4,66.66666667
FHN,SMART,USD,6,4,0,2,0,4,66.66666667
LFUS,SMART,USD,6,4,0,2,0,4,66.66666667
DBX,SMART,USD,6,4,0,2,0,4,66.66666667
BX,SMART,USD,6,4,0,2,0,4,66.66666667
IAA,SMART,USD,6,4,0,2,0,4,66.66666667
NET,SMART,USD,6,4,0,2,0,4,66.66666667
BAM,SMART,USD,6,4,0,2,0,4,66.66666667
RTX,SMART,USD,6,4,0,2,0,4,66.66666667
DDOG,SMART,USD,6,4,0,2,0,4,66.66666667
LI,SMART,USD,6,4,0,2,0,4,66.66666667
XPEV,SMART,USD,6,4,0,2,0,4,66.66666667
COF,SMART,USD,6,3,1,1,1,4,66.66666667
JBLU,SMART,USD,6,3,1,1,1,4,66.66666667
UNF,SMART,USD,6,3,1,1,1,4,66.66666667
SHW,SMART,USD,6,3,1,1,1,4,66.66666667
VFC,SMART,USD,6,3,1,1,1,4,66.66666667
MCO,SMART,USD,6,3,1,1,1,4,66.66666667
SSD,SMART,USD,6,3,1,1,1,4,66.66666667
PCAR,SMART,USD,6,3,1,2,0,4,66.66666667
DLB,SMART,USD,6,3,1,2,0,4,66.66666667
ABC,SMART,USD,6,3,1,2,0,4,66.66666667
EHC,SMART,USD,6,3,1,2,0,4,66.66666667
TARO,SMART,USD,6,3,1,2,0,4,66.66666667
CVX,SMART,USD,6,3,1,2,0,4,66.66666667
GNTX,SMART,USD,6,3,1,2,0,4,66.66666667
FLIR,SMART,USD,6,3,1,2,0,4,66.66666667
CMA,SMART,USD,6,3,1,2,0,4,66.66666667
KLIC,SMART,USD,6,3,1,2,0,4,66.66666667
EQH,SMART,USD,6,3,1,2,0,4,66.66666667
KSU,SMART,USD,6,3,1,2,0,4,66.66666667
MANT,SMART,USD,6,3,1,2,0,4,66.66666667
TMX,SMART,USD,6,2,2,0,2,4,66.66666667
LSXMK,SMART,USD,6,2,2,1,1,4,66.66666667
PFE,SMART,USD,6,2,2,1,1,4,66.66666667
KMPR,SMART,USD,6,2,2,1,1,4,66.66666667
TD,SMART,USD,6,2,2,1,1,4,66.66666667
AY,SMART,USD,6,2,2,1,1,4,66.66666667
SLV,SMART,USD,6,2,2,2,0,4,66.66666667
CP,SMART,USD,6,2,2,2,0,4,66.66666667
SONY,SMART,USD,6,1,3,1,1,4,66.66666667
EXPI,SMART,USD,26,16,1,9,0,17,65.38461538
MRO,SMART,USD,23,15,0,8,0,15,65.2173913
TRQ,SMART,USD,23,15,0,8,0,15,65.2173913
APPS,SMART,USD,20,13,0,7,0,13,65
OVV,SMART,USD,20,13,0,7,0,13,65
FBRX,SMART,USD,20,13,0,7,0,13,65
XEC,SMART,USD,20,13,0,7,0,13,65
AG,SMART,USD,20,12,1,7,0,13,65
DDD,SMART,USD,20,12,1,7,0,13,65
ET,SMART,USD,17,11,0,6,0,11,64.70588235
BZUN,SMART,USD,17,11,0,6,0,11,64.70588235
TSLA,SMART,USD,17,11,0,6,0,11,64.70588235
ROKU,SMART,USD,17,11,0,6,0,11,64.70588235
WGO,SMART,USD,17,10,1,6,0,11,64.70588235
STMP,SMART,USD,17,10,1,6,0,11,64.70588235
BE,SMART,USD,17,10,1,6,0,11,64.70588235
PLUG,SMART,USD,28,18,0,10,0,18,64.28571429
GKOS,SMART,USD,14,9,0,5,0,9,64.28571429
FND,SMART,USD,14,9,0,5,0,9,64.28571429
LB,SMART,USD,14,8,1,3,2,9,64.28571429
TX,SMART,USD,14,8,1,4,1,9,64.28571429
BRFS,SMART,USD,14,7,2,5,0,9,64.28571429
NCLH,SMART,USD,14,6,3,3,2,9,64.28571429
FRHC,SMART,USD,22,12,2,8,0,14,63.63636364
LOB,SMART,USD,11,7,0,3,1,7,63.63636364
DOOO,SMART,USD,11,7,0,3,1,7,63.63636364
CTLT,SMART,USD,11,7,0,4,0,7,63.63636364
HZNP,SMART,USD,11,7,0,4,0,7,63.63636364
GRUB,SMART,USD,11,7,0,4,0,7,63.63636364
DNLI,SMART,USD,11,7,0,4,0,7,63.63636364
ENR,SMART,USD,11,7,0,4,0,7,63.63636364
FEYE,SMART,USD,11,6,1,3,1,7,63.63636364
PLNT,SMART,USD,11,6,1,3,1,7,63.63636364
SHOP,SMART,USD,11,6,1,3,1,7,63.63636364
NEWR,SMART,USD,11,6,1,4,0,7,63.63636364
CRUS,SMART,USD,11,6,1,4,0,7,63.63636364
BYND,SMART,USD,11,6,1,4,0,7,63.63636364
LSCC,SMART,USD,11,5,2,4,0,7,63.63636364
LYB,SMART,USD,11,5,2,4,0,7,63.63636364
MANU,SMART,USD,11,5,2,4,0,7,63.63636364
GMAB,SMART,USD,11,4,3,3,1,7,63.63636364
BCS,SMART,USD,11,4,3,3,1,7,63.63636364
FLOW,SMART,USD,16,9,1,6,0,10,62.5
MIDD,SMART,USD,8,5,0,2,1,5,62.5
ALNY,SMART,USD,8,5,0,3,0,5,62.5
ITUB,SMART,USD,8,5,0,3,0,5,62.5
UBS,SMART,USD,8,5,0,3,0,5,62.5
LPX,SMART,USD,8,5,0,3,0,5,62.5
DAL,SMART,USD,8,5,0,3,0,5,62.5
ALKS,SMART,USD,8,5,0,3,0,5,62.5
FLR,SMART,USD,8,5,0,3,0,5,62.5
UAA,SMART,USD,8,5,0,3,0,5,62.5
FORM,SMART,USD,8,5,0,3,0,5,62.5
HBI,SMART,USD,8,5,0,3,0,5,62.5
SPOT,SMART,USD,8,5,0,3,0,5,62.5
VC,SMART,USD,8,5,0,3,0,5,62.5
LVS,SMART,USD,8,5,0,3,0,5,62.5
BNTX,SMART,USD,8,5,0,3,0,5,62.5
LYV,SMART,USD,8,4,1,2,1,5,62.5
LRCX,SMART,USD,8,4,1,2,1,5,62.5
PYPL,SMART,USD,8,4,1,2,1,5,62.5
RCL,SMART,USD,8,4,1,2,1,5,62.5
NXPI,SMART,USD,8,4,1,2,1,5,62.5
WK,SMART,USD,8,4,1,2,1,5,62.5
TXT,SMART,USD,8,4,1,2,1,5,62.5
CROX,SMART,USD,8,4,1,3,0,5,62.5
BEN,SMART,USD,8,4,1,3,0,5,62.5
ATI,SMART,USD,8,4,1,3,0,5,62.5
MKSI,SMART,USD,8,4,1,3,0,5,62.5
LULU,SMART,USD,8,4,1,3,0,5,62.5
RUSHA,SMART,USD,8,4,1,3,0,5,62.5
BMRN,SMART,USD,8,4,1,3,0,5,62.5
EVTC,SMART,USD,8,4,1,3,0,5,62.5
LECO,SMART,USD,8,4,1,3,0,5,62.5
SIVB,SMART,USD,8,4,1,3,0,5,62.5
MS,SMART,USD,8,4,1,3,0,5,62.5
DAVA,SMART,USD,8,4,1,3,0,5,62.5
DELL,SMART,USD,8,4,1,3,0,5,62.5
RDY,SMART,USD,8,3,2,0,3,5,62.5
HI,SMART,USD,8,3,2,2,1,5,62.5
RS,SMART,USD,8,3,2,2,1,5,62.5
IDXX,SMART,USD,8,3,2,2,1,5,62.5
DORM,SMART,USD,8,3,2,2,1,5,62.5
PNFP,SMART,USD,8,3,2,3,0,5,62.5
BFAM,SMART,USD,8,3,2,3,0,5,62.5
WOR,SMART,USD,8,3,2,3,0,5,62.5
HII,SMART,USD,8,3,2,3,0,5,62.5
CHRW,SMART,USD,8,2,3,2,1,5,62.5
HSBC,SMART,USD,8,2,3,3,0,5,62.5
GE,SMART,USD,34,18,3,13,0,21,61.76470588
BBBY,SMART,USD,13,8,0,5,0,8,61.53846154
BAND,SMART,USD,13,8,0,5,0,8,61.53846154
AMKR,SMART,USD,13,7,1,4,1,8,61.53846154
WIX,SMART,USD,13,7,1,4,1,8,61.53846154
WDC,SMART,USD,13,6,2,4,1,8,61.53846154
MIC,SMART,USD,13,6,2,5,0,8,61.53846154
HFC,SMART,USD,13,5,3,3,2,8,61.53846154
VAC,SMART,USD,13,5,3,4,1,8,61.53846154
BLDP,SMART,USD,18,11,0,7,0,11,61.11111111
DCP,SMART,USD,18,10,1,6,1,11,61.11111111
NVAX,SMART,USD,38,22,1,14,1,23,60.52631579
FATE,SMART,USD,25,15,0,10,0,15,60
VNET,SMART,USD,20,11,1,8,0,12,60
SAGE,SMART,USD,15,9,0,6,0,9,60
GPS,SMART,USD,15,9,0,6,0,9,60
UPWK,SMART,USD,15,8,1,6,0,9,60
NSIT,SMART,USD,15,7,2,5,1,9,60
WB,SMART,USD,15,6,3,6,0,9,60
NVMI,SMART,USD,15,3,6,6,0,9,60
SHAK,SMART,USD,10,6,0,3,1,6,60
INOV,SMART,USD,10,6,0,3,1,6,60
VIACA,SMART,USD,10,6,0,3,1,6,60
ASND,SMART,USD,10,6,0,4,0,6,60
LPSN,SMART,USD,10,6,0,4,0,6,60
HRI,SMART,USD,10,6,0,4,0,6,60
BLKB,SMART,USD,10,6,0,4,0,6,60
CG,SMART,USD,10,6,0,4,0,6,60
TWOU,SMART,USD,10,6,0,4,0,6,60
INSP,SMART,USD,10,6,0,4,0,6,60
MTG,SMART,USD,10,5,1,2,2,6,60
APTV,SMART,USD,10,5,1,3,1,6,60
NAVI,SMART,USD,10,5,1,3,1,6,60
AUB,SMART,USD,10,5,1,3,1,6,60
WAL,SMART,USD,10,5,1,4,0,6,60
AUY,SMART,USD,10,5,1,4,0,6,60
MGY,SMART,USD,10,5,1,4,0,6,60
SNX,SMART,USD,10,4,2,3,1,6,60
SUN,SMART,USD,10,3,3,4,0,6,60
QTWO,SMART,USD,10,3,3,4,0,6,60
CNA,SMART,USD,5,3,0,0,2,3,60
AIT,SMART,USD,5,3,0,0,2,3,60
WRB,SMART,USD,5,3,0,0,2,3,60
ENIA,SMART,USD,5,3,0,1,1,3,60
TMUS,SMART,USD,5,3,0,1,1,3,60
NICE,SMART,USD,5,3,0,1,1,3,60
GIB,SMART,USD,5,3,0,1,1,3,60
FCFS,SMART,USD,5,3,0,1,1,3,60
SCHW,SMART,USD,5,3,0,1,1,3,60
XLE,SMART,USD,5,3,0,1,1,3,60
QRVO,SMART,USD,5,3,0,2,0,3,60
FDX,SMART,USD,5,3,0,2,0,3,60
LOPE,SMART,USD,5,3,0,2,0,3,60
MCY,SMART,USD,5,3,0,2,0,3,60
MLM,SMART,USD,5,3,0,2,0,3,60
WBK,SMART,USD,5,3,0,2,0,3,60
OKTA,SMART,USD,5,3,0,2,0,3,60
LII,SMART,USD,5,3,0,2,0,3,60
WH,SMART,USD,5,3,0,2,0,3,60
SVMK,SMART,USD,5,3,0,2,0,3,60
ARD,SMART,USD,5,3,0,2,0,3,60
HHC,SMART,USD,5,3,0,2,0,3,60
OPCH,SMART,USD,5,3,0,2,0,3,60
DT,SMART,USD,5,3,0,2,0,3,60
BEAM,SMART,USD,5,3,0,2,0,3,60
BILL,SMART,USD,5,3,0,2,0,3,60
ARNC,SMART,USD,5,3,0,2,0,3,60
QS,SMART,USD,5,3,0,2,0,3,60
EVR,SMART,USD,5,2,1,1,1,3,60
BCPC,SMART,USD,5,2,1,1,1,3,60
EFX,SMART,USD,5,2,1,1,1,3,60
INFY,SMART,USD,5,2,1,1,1,3,60
RACE,SMART,USD,5,2,1,1,1,3,60
RBA,SMART,USD,5,2,1,1,1,3,60
WMT,SMART,USD,5,2,1,1,1,3,60
HXL,SMART,USD,5,2,1,2,0,3,60
UL,SMART,USD,5,2,1,2,0,3,60
KHC,SMART,USD,5,2,1,2,0,3,60
LSXMA,SMART,USD,5,2,1,2,0,3,60
PNC,SMART,USD,5,2,1,2,0,3,60
FMC,SMART,USD,5,2,1,2,0,3,60
NOC,SMART,USD,5,2,1,2,0,3,60
BTI,SMART,USD,5,2,1,2,0,3,60
SWK,SMART,USD,5,2,1,2,0,3,60
MPWR,SMART,USD,5,2,1,2,0,3,60
WLTW,SMART,USD,5,2,1,2,0,3,60
FITB,SMART,USD,5,2,1,2,0,3,60
BCE,SMART,USD,5,2,1,2,0,3,60
GBCI,SMART,USD,5,1,2,1,1,3,60
AZN,SMART,USD,5,1,2,1,1,3,60
SKM,SMART,USD,5,1,2,1,1,3,60
TBT,SMART,USD,5,1,2,2,0,3,60
QSR,SMART,USD,5,1,2,2,0,3,60
CFR,SMART,USD,5,1,2,2,0,3,60
WLK,SMART,USD,5,1,2,2,0,3,60
BSX,SMART,USD,5,1,2,2,0,3,60
PBCT,SMART,USD,5,1,2,2,0,3,60
MTB,SMART,USD,5,0,3,1,1,3,60
CIEN,SMART,USD,5,0,3,1,1,3,60
FULT,SMART,USD,5,0,3,2,0,3,60
TGT,SMART,USD,5,0,3,2,0,3,60
VLY,SMART,USD,5,0,3,2,0,3,60
TLRY,SMART,USD,17,10,0,7,0,10,58.82352941
MTDR,SMART,USD,17,9,1,7,0,10,58.82352941
MITK,SMART,USD,17,9,1,7,0,10,58.82352941
CIXX,SMART,USD,17,5,5,7,0,10,58.82352941
ANSS,SMART,USD,12,7,0,2,3,7,58.33333333
TREE,SMART,USD,12,7,0,3,2,7,58.33333333
CX,SMART,USD,12,7,0,4,1,7,58.33333333
COOP,SMART,USD,12,7,0,5,0,7,58.33333333
TXRH,SMART,USD,12,7,0,5,0,7,58.33333333
KOD,SMART,USD,12,7,0,5,0,7,58.33333333
STNE,SMART,USD,12,7,0,5,0,7,58.33333333
FVRR,SMART,USD,12,7,0,5,0,7,58.33333333
SBS,SMART,USD,12,6,1,4,1,7,58.33333333
HAL,SMART,USD,12,6,1,5,0,7,58.33333333
PRGO,SMART,USD,12,5,2,4,1,7,58.33333333
UMC,SMART,USD,12,5,2,5,0,7,58.33333333
SSTK,SMART,USD,12,5,2,5,0,7,58.33333333
PII,SMART,USD,12,5,2,5,0,7,58.33333333
BB,SMART,USD,19,9,2,8,0,11,57.89473684
SBSW,SMART,USD,21,12,0,9,0,12,57.14285714
CVE,SMART,USD,21,9,3,9,0,12,57.14285714
AMD,SMART,USD,14,8,0,6,0,8,57.14285714
NTLA,SMART,USD,14,8,0,6,0,8,57.14285714
HQY,SMART,USD,14,8,0,6,0,8,57.14285714
TRGP,SMART,USD,14,7,1,6,0,8,57.14285714
AA,SMART,USD,14,7,1,6,0,8,57.14285714
USO,SMART,USD,14,6,2,5,1,8,57.14285714
OXY,SMART,USD,14,6,2,5,1,8,57.14285714
GM,SMART,USD,14,6,2,6,0,8,57.14285714
BBDO,SMART,USD,14,6,2,6,0,8,57.14285714
DB,SMART,USD,14,4,4,5,1,8,57.14285714
NXST,SMART,USD,7,4,0,0,3,4,57.14285714
SF,SMART,USD,7,4,0,1,2,4,57.14285714
VIAV,SMART,USD,7,4,0,1,2,4,57.14285714
CMD,SMART,USD,7,4,0,1,2,4,57.14285714
SAN,SMART,USD,7,4,0,2,1,4,57.14285714
VST,SMART,USD,7,4,0,2,1,4,57.14285714
RJF,SMART,USD,7,4,0,2,1,4,57.14285714
SSNC,SMART,USD,7,4,0,2,1,4,57.14285714
MTD,SMART,USD,7,4,0,2,1,4,57.14285714
ALLY,SMART,USD,7,4,0,3,0,4,57.14285714
ARES,SMART,USD,7,4,0,3,0,4,57.14285714
MAN,SMART,USD,7,4,0,3,0,4,57.14285714
SFM,SMART,USD,7,4,0,3,0,4,57.14285714
MGA,SMART,USD,7,4,0,3,0,4,57.14285714
SAM,SMART,USD,7,4,0,3,0,4,57.14285714
TNET,SMART,USD,7,4,0,3,0,4,57.14285714
TAC,SMART,USD,7,4,0,3,0,4,57.14285714
LAD,SMART,USD,7,4,0,3,0,4,57.14285714
HOG,SMART,USD,7,4,0,3,0,4,57.14285714
GH,SMART,USD,7,4,0,3,0,4,57.14285714
TPTX,SMART,USD,7,4,0,3,0,4,57.14285714
RAMP,SMART,USD,7,4,0,3,0,4,57.14285714
AGO,SMART,USD,7,3,1,1,2,4,57.14285714
ENIC,SMART,USD,7,3,1,1,2,4,57.14285714
ADSK,SMART,USD,7,3,1,2,1,4,57.14285714
KEX,SMART,USD,7,3,1,2,1,4,57.14285714
ZBRA,SMART,USD,7,3,1,2,1,4,57.14285714
AMP,SMART,USD,7,3,1,2,1,4,57.14285714
HRL,SMART,USD,7,3,1,2,1,4,57.14285714
E,SMART,USD,7,3,1,2,1,4,57.14285714
POST,SMART,USD,7,3,1,2,1,4,57.14285714
TCOM,SMART,USD,7,3,1,3,0,4,57.14285714
EXP,SMART,USD,7,3,1,3,0,4,57.14285714
TAK,SMART,USD,7,3,1,3,0,4,57.14285714
NOK,SMART,USD,7,3,1,3,0,4,57.14285714
CCIV,SMART,USD,7,3,1,3,0,4,57.14285714
SEIC,SMART,USD,7,2,2,1,2,4,57.14285714
AMGN,SMART,USD,7,2,2,1,2,4,57.14285714
NVS,SMART,USD,7,2,2,2,1,4,57.14285714
UNVR,SMART,USD,7,2,2,3,0,4,57.14285714
SMFG,SMART,USD,7,2,2,3,0,4,57.14285714
GT,SMART,USD,7,2,2,3,0,4,57.14285714
HUBB,SMART,USD,7,2,2,3,0,4,57.14285714
ASB,SMART,USD,7,1,3,1,2,4,57.14285714
CHH,SMART,USD,7,1,3,3,0,4,57.14285714
QGEN,SMART,USD,7,0,4,3,0,4,57.14285714
FCEL,SMART,USD,37,21,0,16,0,21,56.75675676
TTM,SMART,USD,23,10,3,10,0,13,56.52173913
VIPS,SMART,USD,16,9,0,7,0,9,56.25
BAK,SMART,USD,16,8,1,6,1,9,56.25
DEN,SMART,USD,34,19,0,15,0,19,55.88235294
ITCI,SMART,USD,18,10,0,8,0,10,55.55555556
SGEN,SMART,USD,9,5,0,3,1,5,55.55555556
WCC,SMART,USD,9,5,0,3,1,5,55.55555556
VTRS,SMART,USD,9,5,0,3,1,5,55.55555556
KSS,SMART,USD,9,5,0,3,1,5,55.55555556
PSXP,SMART,USD,9,5,0,4,0,5,55.55555556
MTN,SMART,USD,9,5,0,4,0,5,55.55555556
ADPT,SMART,USD,9,5,0,4,0,5,55.55555556
CRNC,SMART,USD,9,5,0,4,0,5,55.55555556
JBT,SMART,USD,9,4,1,1,3,5,55.55555556
AMG,SMART,USD,9,4,1,2,2,5,55.55555556
MMSI,SMART,USD,9,4,1,3,1,5,55.55555556
AGI,SMART,USD,9,4,1,4,0,5,55.55555556
KL,SMART,USD,9,4,1,4,0,5,55.55555556
NG,SMART,USD,9,4,1,4,0,5,55.55555556
MSTR,SMART,USD,9,4,1,4,0,5,55.55555556
EMN,SMART,USD,9,4,1,4,0,5,55.55555556
HSIC,SMART,USD,9,3,2,1,3,5,55.55555556
WERN,SMART,USD,9,3,2,4,0,5,55.55555556
PTC,SMART,USD,9,3,2,4,0,5,55.55555556
LMT,SMART,USD,9,1,4,4,0,5,55.55555556
BSMX,SMART,USD,20,10,1,9,0,11,55
AXON,SMART,USD,20,8,3,9,0,11,55
INFO,SMART,USD,4,4,0,0,0,4,100
MHK,SMART,USD,4,4,0,0,0,4,100
KNX,SMART,USD,4,4,0,0,0,4,100
CCJ,SMART,USD,4,4,0,0,0,4,100
KO,SMART,USD,4,4,0,0,0,4,100
AFG,SMART,USD,4,4,0,0,0,4,100
EBAY,SMART,USD,4,4,0,0,0,4,100
PAYX,SMART,USD,4,4,0,0,0,4,100
PRSP,SMART,USD,4,4,0,0,0,4,100
WDAY,SMART,USD,4,4,0,0,0,4,100
RGLD,SMART,USD,4,4,0,0,0,4,100
ACM,SMART,USD,4,4,0,0,0,4,100
HD,SMART,USD,4,4,0,0,0,4,100
ROST,SMART,USD,4,4,0,0,0,4,100
CRI,SMART,USD,4,4,0,0,0,4,100
ALSN,SMART,USD,4,4,0,0,0,4,100
INMD,SMART,USD,4,4,0,0,0,4,100
ECL,SMART,USD,4,4,0,0,0,4,100
TXG,SMART,USD,4,4,0,0,0,4,100
NVST,SMART,USD,4,4,0,0,0,4,100
J,SMART,USD,4,3,1,0,0,4,100
FCN,SMART,USD,4,3,1,0,0,4,100
CQP,SMART,USD,4,3,1,0,0,4,100
CCMP,SMART,USD,4,3,1,0,0,4,100
CR,SMART,USD,4,3,1,0,0,4,100
BERY,SMART,USD,4,3,1,0,0,4,100
BRC,SMART,USD,4,3,1,0,0,4,100
SO,SMART,USD,4,3,1,0,0,4,100
FB,SMART,USD,4,2,2,0,0,4,100
COST,SMART,USD,4,2,2,0,0,4,100
CBSH,SMART,USD,4,2,2,0,0,4,100
RSG,SMART,USD,4,2,2,0,0,4,100
ES,SMART,USD,4,2,2,0,0,4,100
WEN,SMART,USD,4,2,2,0,0,4,100
ABB,SMART,USD,4,1,3,0,0,4,100
INGR,SMART,USD,4,1,3,0,0,4,100
TEL,SMART,USD,4,3,0,0,1,3,75
BK,SMART,USD,4,3,0,0,1,3,75
AES,SMART,USD,4,3,0,0,1,3,75
MXIM,SMART,USD,4,3,0,0,1,3,75
USM,SMART,USD,4,3,0,0,1,3,75
PSX,SMART,USD,4,3,0,0,1,3,75
PINC,SMART,USD,4,3,0,0,1,3,75
CTXS,SMART,USD,4,3,0,0,1,3,75
BXP,SMART,USD,4,3,0,1,0,3,75
BCO,SMART,USD,4,3,0,1,0,3,75
EVBG,SMART,USD,4,3,0,1,0,3,75
C,SMART,USD,4,3,0,1,0,3,75
INTU,SMART,USD,4,3,0,1,0,3,75
MSCI,SMART,USD,4,3,0,1,0,3,75
NJR,SMART,USD,4,3,0,1,0,3,75
AEP,SMART,USD,4,3,0,1,0,3,75
EME,SMART,USD,4,3,0,1,0,3,75
ISBC,SMART,USD,4,3,0,1,0,3,75
VVV,SMART,USD,4,3,0,1,0,3,75
PG,SMART,USD,4,3,0,1,0,3,75
DAN,SMART,USD,4,3,0,1,0,3,75
COLB,SMART,USD,4,3,0,1,0,3,75
TOT,SMART,USD,4,3,0,1,0,3,75
PGNY,SMART,USD,4,3,0,1,0,3,75
SNPS,SMART,USD,4,3,0,1,0,3,75
MMP,SMART,USD,4,3,0,1,0,3,75
ONEM,SMART,USD,4,3,0,1,0,3,75
PCT,SMART,USD,4,3,0,1,0,3,75
NARI,SMART,USD,4,3,0,1,0,3,75
AMWL,SMART,USD,4,3,0,1,0,3,75
T,SMART,USD,4,2,1,0,1,3,75
ADI,SMART,USD,4,2,1,0,1,3,75
HUN,SMART,USD,4,2,1,1,0,3,75
BLD,SMART,USD,4,2,1,1,0,3,75
SFBS,SMART,USD,4,2,1,1,0,3,75
WFC,SMART,USD,4,2,1,1,0,3,75
GPN,SMART,USD,4,2,1,1,0,3,75
G,SMART,USD,4,2,1,1,0,3,75
GD,SMART,USD,4,2,1,1,0,3,75
CTAS,SMART,USD,4,2,1,1,0,3,75
UFPI,SMART,USD,4,2,1,1,0,3,75
SIGI,SMART,USD,4,2,1,1,0,3,75
PNR,SMART,USD,4,2,1,1,0,3,75
IBKR,SMART,USD,4,2,1,1,0,3,75
QCOM,SMART,USD,4,2,1,1,0,3,75
ICUI,SMART,USD,4,2,1,1,0,3,75
PTR,SMART,USD,4,2,1,1,0,3,75
CHE,SMART,USD,4,2,1,1,0,3,75
BUD,SMART,USD,4,2,1,1,0,3,75
AMED,SMART,USD,4,2,1,1,0,3,75
UPS,SMART,USD,4,2,1,1,0,3,75
ERIE,SMART,USD,4,2,1,1,0,3,75
AIN,SMART,USD,4,2,1,1,0,3,75
IBM,SMART,USD,4,2,1,1,0,3,75
WF,SMART,USD,4,2,1,1,0,3,75
SWX,SMART,USD,4,2,1,1,0,3,75
ALE,SMART,USD,4,2,1,1,0,3,75
SJR,SMART,USD,4,2,1,1,0,3,75
ORCL,SMART,USD,4,1,2,0,1,3,75
UCBI,SMART,USD,4,1,2,1,0,3,75
TIGO,SMART,USD,4,1,2,1,0,3,75
SXT,SMART,USD,4,1,2,1,0,3,75
UGI,SMART,USD,4,1,2,1,0,3,75
ASML,SMART,USD,4,1,2,1,0,3,75
BOH,SMART,USD,4,1,2,1,0,3,75
UMPQ,SMART,USD,4,0,3,1,0,3,75
ICLR,SMART,USD,3,3,0,0,0,3,100
AOS,SMART,USD,3,3,0,0,0,3,100
GRA,SMART,USD,3,3,0,0,0,3,100
TTEK,SMART,USD,3,3,0,0,0,3,100
NVR,SMART,USD,3,3,0,0,0,3,100
TECH,SMART,USD,3,3,0,0,0,3,100
VMC,SMART,USD,3,3,0,0,0,3,100
JACK,SMART,USD,3,3,0,0,0,3,100
PWR,SMART,USD,3,3,0,0,0,3,100
OTEX,SMART,USD,3,3,0,0,0,3,100
CASY,SMART,USD,3,3,0,0,0,3,100
PPL,SMART,USD,3,3,0,0,0,3,100
AMCR,SMART,USD,3,3,0,0,0,3,100
IT,SMART,USD,3,3,0,0,0,3,100
SHG,SMART,USD,3,3,0,0,0,3,100
PPD,SMART,USD,3,3,0,0,0,3,100
AVA,SMART,USD,3,3,0,0,0,3,100
RXT,SMART,USD,3,3,0,0,0,3,100
BLI,SMART,USD,3,3,0,0,0,3,100
BEPC,SMART,USD,3,3,0,0,0,3,100
RLX,SMART,USD,3,3,0,0,0,3,100
STN,SMART,USD,3,2,1,0,0,3,100
COO,SMART,USD,3,2,1,0,0,3,100
CMI,SMART,USD,3,2,1,0,0,3,100
ORLY,SMART,USD,3,2,1,0,0,3,100
CDNS,SMART,USD,3,2,1,0,0,3,100
FMS,SMART,USD,3,2,1,0,0,3,100
LSTR,SMART,USD,3,2,1,0,0,3,100
TRP,SMART,USD,3,2,1,0,0,3,100
NDSN,SMART,USD,3,2,1,0,0,3,100
NKE,SMART,USD,3,2,1,0,0,3,100
WEC,SMART,USD,3,2,1,0,0,3,100
MMM,SMART,USD,3,1,2,0,0,3,100
MUSA,SMART,USD,3,1,2,0,0,3,100
APAM,SMART,USD,3,2,0,0,1,2,66.66666667
AFL,SMART,USD,3,2,0,0,1,2,66.66666667
GOOG,SMART,USD,3,2,0,0,1,2,66.66666667
AGR,SMART,USD,3,2,0,0,1,2,66.66666667
EXPO,SMART,USD,3,2,0,0,1,2,66.66666667
LIVN,SMART,USD,3,2,0,0,1,2,66.66666667
HOMB,SMART,USD,3,2,0,1,0,2,66.66666667
MCD,SMART,USD,3,2,0,1,0,2,66.66666667
TSN,SMART,USD,3,2,0,1,0,2,66.66666667
LW,SMART,USD,3,2,0,1,0,2,66.66666667
RLI,SMART,USD,3,2,0,1,0,2,66.66666667
LHCG,SMART,USD,3,2,0,1,0,2,66.66666667
CB,SMART,USD,3,2,0,1,0,2,66.66666667
RNR,SMART,USD,3,2,0,1,0,2,66.66666667
LBRDA,SMART,USD,3,2,0,1,0,2,66.66666667
DIS,SMART,USD,3,2,0,1,0,2,66.66666667
TMO,SMART,USD,3,2,0,1,0,2,66.66666667
USB,SMART,USD,3,2,0,1,0,2,66.66666667
OMC,SMART,USD,3,2,0,1,0,2,66.66666667
HELE,SMART,USD,3,2,0,1,0,2,66.66666667
GRMN,SMART,USD,3,2,0,1,0,2,66.66666667
AVT,SMART,USD,3,2,0,1,0,2,66.66666667
LDOS,SMART,USD,3,2,0,1,0,2,66.66666667
MTX,SMART,USD,3,2,0,1,0,2,66.66666667
POOL,SMART,USD,3,2,0,1,0,2,66.66666667
MKC,SMART,USD,3,2,0,1,0,2,66.66666667
NNI,SMART,USD,3,2,0,0,1,2,66.66666667
PFGC,SMART,USD,3,2,0,1,0,2,66.66666667
FTDR,SMART,USD,3,2,0,1,0,2,66.66666667
AVLR,SMART,USD,3,2,0,1,0,2,66.66666667
UBER,SMART,USD,3,2,0,1,0,2,66.66666667
CRM,SMART,USD,3,2,0,1,0,2,66.66666667
DUK,SMART,USD,3,2,0,1,0,2,66.66666667
TW,SMART,USD,3,2,0,1,0,2,66.66666667
ED,SMART,USD,3,2,0,1,0,2,66.66666667
NI,SMART,USD,3,2,0,1,0,2,66.66666667
HE,SMART,USD,3,2,0,1,0,2,66.66666667
SRE,SMART,USD,3,2,0,1,0,2,66.66666667
GSK,SMART,USD,3,2,0,1,0,2,66.66666667
BMO,SMART,USD,3,2,0,1,0,2,66.66666667
REYN,SMART,USD,3,2,0,1,0,2,66.66666667
PKI,SMART,USD,3,2,0,1,0,2,66.66666667
BIPC,SMART,USD,3,2,0,1,0,2,66.66666667
SLQT,SMART,USD,3,2,0,1,0,2,66.66666667
LEGN,SMART,USD,3,2,0,1,0,2,66.66666667
BEKE,SMART,USD,3,2,0,1,0,2,66.66666667
DADA,SMART,USD,3,2,0,1,0,2,66.66666667
SNOW,SMART,USD,3,2,0,1,0,2,66.66666667
ASAN,SMART,USD,3,2,0,1,0,2,66.66666667
AAN,SMART,USD,3,2,0,1,0,2,66.66666667
UPST,SMART,USD,3,2,0,1,0,2,66.66666667
AZO,SMART,USD,3,1,1,0,1,2,66.66666667
VRNT,SMART,USD,3,1,1,1,0,2,66.66666667
MSA,SMART,USD,3,1,1,1,0,2,66.66666667
GL,SMART,USD,3,1,1,1,0,2,66.66666667
NVO,SMART,USD,3,1,1,1,0,2,66.66666667
SAFM,SMART,USD,3,1,1,1,0,2,66.66666667
STE,SMART,USD,3,1,1,1,0,2,66.66666667
SRCL,SMART,USD,3,1,1,1,0,2,66.66666667
IBOC,SMART,USD,3,1,1,1,0,2,66.66666667
UNH,SMART,USD,3,1,1,1,0,2,66.66666667
SLGN,SMART,USD,3,1,1,1,0,2,66.66666667
UI,SMART,USD,3,1,1,1,0,2,66.66666667
WIT,SMART,USD,3,1,1,1,0,2,66.66666667
NEE,SMART,USD,3,1,1,1,0,2,66.66666667
HSY,SMART,USD,3,0,2,0,1,2,66.66666667
RMD,SMART,USD,2,2,0,0,0,2,100
CME,SMART,USD,2,2,0,0,0,2,100
LAUR,SMART,USD,2,2,0,0,0,2,100
MSFT,SMART,USD,2,2,0,0,0,2,100
DGX,SMART,USD,2,2,0,0,0,2,100
IEX,SMART,USD,2,2,0,0,0,2,100
ITW,SMART,USD,2,2,0,0,0,2,100
UBSI,SMART,USD,2,2,0,0,0,2,100
GIS,SMART,USD,2,2,0,0,0,2,100
INDB,SMART,USD,2,2,0,0,0,2,100
D,SMART,USD,2,2,0,0,0,2,100
BRO,SMART,USD,2,2,0,0,0,2,100
ALL,SMART,USD,2,2,0,0,0,2,100
ETR,SMART,USD,2,2,0,0,0,2,100
IDA,SMART,USD,2,2,0,0,0,2,100
PSN,SMART,USD,2,2,0,0,0,2,100
GHC,SMART,USD,2,2,0,0,0,2,100
CNP,SMART,USD,2,2,0,0,0,2,100
VRM,SMART,USD,2,2,0,0,0,2,100
ACCD,SMART,USD,2,2,0,0,0,2,100
BIGC,SMART,USD,2,2,0,0,0,2,100
VERX,SMART,USD,2,2,0,0,0,2,100
OSH,SMART,USD,2,2,0,0,0,2,100
RKT,SMART,USD,2,2,0,0,0,2,100
ACI,SMART,USD,2,2,0,0,0,2,100
GOCO,SMART,USD,2,2,0,0,0,2,100
ARVL,SMART,USD,2,2,0,0,0,2,100
DASH,SMART,USD,2,2,0,0,0,2,100
NCNO,SMART,USD,2,2,0,0,0,2,100
ABCL,SMART,USD,2,2,0,0,0,2,100
TROW,SMART,USD,2,1,1,0,0,2,100
EXC,SMART,USD,2,1,1,0,0,2,100
SBUX,SMART,USD,2,1,1,0,0,2,100
FISV,SMART,USD,2,1,1,0,0,2,100
EVRG,SMART,USD,2,1,1,0,0,2,100
DEO,SMART,USD,2,1,1,0,0,2,100
CARR,SMART,USD,2,1,1,0,0,2,100
TYL,SMART,USD,1,1,0,0,0,1,100
CI,SMART,USD,1,1,0,0,0,1,100
WST,SMART,USD,1,1,0,0,0,1,100
NWE,SMART,USD,1,1,0,0,0,1,100
SCL,SMART,USD,1,1,0,0,0,1,100
AEE,SMART,USD,1,1,0,0,0,1,100
CHD,SMART,USD,1,1,0,0,0,1,100
POR,SMART,USD,1,1,0,0,0,1,100
JJSF,SMART,USD,1,1,0,0,0,1,100
MDT,SMART,USD,1,1,0,0,0,1,100
DTE,SMART,USD,1,1,0,0,0,1,100
CABO,SMART,USD,1,1,0,0,0,1,100
DCI,SMART,USD,1,1,0,0,0,1,100
AXP,SMART,USD,1,1,0,0,0,1,100
CSL,SMART,USD,1,1,0,0,0,1,100
JEF,SMART,USD,1,1,0,0,0,1,100
OGE,SMART,USD,1,1,0,0,0,1,100
GO,SMART,USD,1,1,0,0,0,1,100
JAMF,SMART,USD,1,1,0,0,0,1,100
FOUR,SMART,USD,1,1,0,0,0,1,100
MPLN,SMART,USD,1,1,0,0,0,1,100
FIS,SMART,USD,1,1,0,0,0,1,100
RPRX,SMART,USD,1,1,0,0,0,1,100
MSP,SMART,USD,1,1,0,0,0,1,100
PRG,SMART,USD,1,1,0,0,0,1,100
ABCM,SMART,USD,1,1,0,0,0,1,100
BSY,SMART,USD,1,1,0,0,0,1,100
CLX,SMART,USD,1,1,0,0,0,1,100
LESL,SMART,USD,1,1,0,0,0,1,100
AFRM,SMART,USD,1,1,0,0,0,1,100
DRVN,SMART,USD,1,1,0,0,0,1,100
BUR,SMART,USD,1,1,0,0,0,1,100
ATVI,SMART,USD,1,1,0,0,0,1,100
WOOF,SMART,USD,1,1,0,0,0,1,100
XM,SMART,USD,1,1,0,0,0,1,100
SANA,SMART,USD,1,1,0,0,0,1,100
CERT,SMART,USD,1,1,0,0,0,1,100
CNXC,SMART,USD,1,1,0,0,0,1,100
ZIM,SMART,USD,1,1,0,0,0,1,100
OSCR,SMART,USD,1,1,0,0,0,1,100
ACVA,SMART,USD,1,1,0,0,0,1,100
ALHC,SMART,USD,1,1,0,0,0,1,100
ZH,SMART,USD,1,1,0,0,0,1,100
AIZ,SMART,USD,1,0,1,0,0,1,100
CMS,SMART,USD,1,0,1,0,0,1,100
BDX,SMART,USD,1,0,1,0,0,1,100
FUL,SMART,USD,11,6,0,3,2,6,54.54545455
NCR,SMART,USD,11,6,0,4,1,6,54.54545455
NVDA,SMART,USD,11,6,0,4,1,6,54.54545455
TNL,SMART,USD,11,6,0,4,1,6,54.54545455
CORT,SMART,USD,11,6,0,5,0,6,54.54545455
RPD,SMART,USD,11,6,0,5,0,6,54.54545455
HMY,SMART,USD,11,6,0,5,0,6,54.54545455
HCM,SMART,USD,11,6,0,5,0,6,54.54545455
APPF,SMART,USD,11,6,0,5,0,6,54.54545455
WBS,SMART,USD,11,4,2,4,1,6,54.54545455
MLCO,SMART,USD,11,4,2,5,0,6,54.54545455
GLPG,SMART,USD,11,4,2,5,0,6,54.54545455
PAYS,SMART,USD,26,13,1,12,0,14,53.84615385
DY,SMART,USD,13,7,0,5,1,7,53.84615385
GWPH,SMART,USD,13,7,0,6,0,7,53.84615385
BRKS,SMART,USD,13,7,0,6,0,7,53.84615385
GGB,SMART,USD,13,7,0,6,0,7,53.84615385
SNAP,SMART,USD,13,7,0,6,0,7,53.84615385
VEON,SMART,USD,13,6,1,4,2,7,53.84615385
IIVI,SMART,USD,13,6,1,5,1,7,53.84615385
AEG,SMART,USD,13,6,1,6,0,7,53.84615385
FIZZ,SMART,USD,13,6,1,6,0,7,53.84615385
RL,SMART,USD,13,5,2,6,0,7,53.84615385
PBR,SMART,USD,15,8,0,7,0,8,53.33333333
MTSI,SMART,USD,15,7,1,7,0,8,53.33333333
SNBR,SMART,USD,17,8,1,8,0,9,52.94117647
WFG,SMART,USD,19,7,3,7,2,10,52.63157895
AMC,SMART,USD,20,10,0,10,0,10,50
M,SMART,USD,16,7,1,8,0,8,50
EXAS,SMART,USD,14,7,0,7,0,7,50
YY,SMART,USD,14,7,0,7,0,7,50
XPO,SMART,USD,14,7,0,7,0,7,50
ROG,SMART,USD,14,6,1,6,1,7,50
TEVA,SMART,USD,14,6,1,6,1,7,50
CC,SMART,USD,14,6,1,7,0,7,50
MPC,SMART,USD,14,5,2,7,0,7,50
GFI,SMART,USD,12,6,0,5,1,6,50
BKR,SMART,USD,12,6,0,5,1,6,50
TEX,SMART,USD,12,6,0,6,0,6,50
TPX,SMART,USD,12,6,0,6,0,6,50
AR,SMART,USD,12,6,0,6,0,6,50
JBL,SMART,USD,12,5,1,6,0,6,50
NTES,SMART,USD,12,4,2,6,0,6,50
VIRT,SMART,USD,10,5,0,3,2,5,50
CGNX,SMART,USD,10,5,0,5,0,5,50
ABMD,SMART,USD,10,5,0,5,0,5,50
CADE,SMART,USD,10,4,1,4,1,5,50
SEM,SMART,USD,10,4,1,5,0,5,50
ARMK,SMART,USD,10,4,1,5,0,5,50
BP,SMART,USD,10,4,1,5,0,5,50
CRH,SMART,USD,10,3,2,4,1,5,50
PSEC,SMART,USD,10,3,2,5,0,5,50
APH,SMART,USD,10,2,3,4,1,5,50
CNNE,SMART,USD,10,2,3,5,0,5,50
GOLF,SMART,USD,10,2,3,5,0,5,50
CLH,SMART,USD,8,4,0,3,1,4,50
CENT,SMART,USD,8,4,0,3,1,4,50
CMG,SMART,USD,8,4,0,3,1,4,50
IBN,SMART,USD,8,4,0,4,0,4,50
PHM,SMART,USD,8,4,0,4,0,4,50
CF,SMART,USD,8,4,0,4,0,4,50
PCTY,SMART,USD,8,4,0,4,0,4,50
MAT,SMART,USD,8,4,0,4,0,4,50
DKNG,SMART,USD,8,4,0,4,0,4,50
PKG,SMART,USD,8,3,1,3,1,4,50
GPC,SMART,USD,8,3,1,3,1,4,50
FNV,SMART,USD,8,3,1,3,1,4,50
STZ,SMART,USD,8,3,1,3,1,4,50
SYNA,SMART,USD,8,3,1,4,0,4,50
ORA,SMART,USD,8,3,1,4,0,4,50
OSK,SMART,USD,8,3,1,4,0,4,50
ABG,SMART,USD,8,3,1,4,0,4,50
MC,SMART,USD,8,3,1,4,0,4,50
SANM,SMART,USD,8,3,1,4,0,4,50
WSC,SMART,USD,8,3,1,4,0,4,50
WWD,SMART,USD,8,3,1,4,0,4,50
CE,SMART,USD,8,2,2,2,2,4,50
EEFT,SMART,USD,8,2,2,3,1,4,50
GATX,SMART,USD,8,2,2,4,0,4,50
RBC,SMART,USD,8,2,2,4,0,4,50
NEP,SMART,USD,8,2,2,4,0,4,50
K,SMART,USD,8,1,3,4,0,4,50
ORAN,SMART,USD,6,3,0,2,1,3,50
MCHP,SMART,USD,6,3,0,2,1,3,50
BURL,SMART,USD,6,3,0,2,1,3,50
GWW,SMART,USD,6,3,0,2,1,3,50
MUFG,SMART,USD,6,3,0,3,0,3,50
APD,SMART,USD,6,3,0,3,0,3,50
PFPT,SMART,USD,6,3,0,3,0,3,50
SLAB,SMART,USD,6,3,0,3,0,3,50
RNG,SMART,USD,6,3,0,3,0,3,50
SAIA,SMART,USD,6,3,0,3,0,3,50
PBA,SMART,USD,6,3,0,3,0,3,50
BHF,SMART,USD,6,3,0,3,0,3,50
XLNX,SMART,USD,6,3,0,3,0,3,50
LEVI,SMART,USD,6,3,0,3,0,3,50
CINF,SMART,USD,6,3,0,3,0,3,50
HIG,SMART,USD,6,3,0,3,0,3,50
FSR,SMART,USD,6,3,0,3,0,3,50
PPG,SMART,USD,6,2,1,1,2,3,50
AME,SMART,USD,6,2,1,2,1,3,50
EMR,SMART,USD,6,2,1,2,1,3,50
AXS,SMART,USD,6,2,1,2,1,3,50
BAC,SMART,USD,6,2,1,2,1,3,50
ERIC,SMART,USD,6,2,1,3,0,3,50
VMW,SMART,USD,6,2,1,3,0,3,50
WPP,SMART,USD,6,2,1,3,0,3,50
TJX,SMART,USD,6,2,1,3,0,3,50
MORN,SMART,USD,6,1,2,3,0,3,50
CMC,SMART,USD,6,1,2,3,0,3,50
SLF,SMART,USD,4,2,0,0,2,2,50
TRI,SMART,USD,4,2,0,0,2,2,50
BKH,SMART,USD,4,2,0,0,2,2,50
GOOGL,SMART,USD,4,2,0,0,2,2,50
ABCB,SMART,USD,4,2,0,1,1,2,50
SPXC,SMART,USD,4,2,0,1,1,2,50
CSGP,SMART,USD,4,2,0,1,1,2,50
CWK,SMART,USD,4,2,0,1,1,2,50
JHG,SMART,USD,4,2,0,1,1,2,50
YUM,SMART,USD,4,2,0,2,0,2,50
MFG,SMART,USD,4,2,0,2,0,2,50
TIMB,SMART,USD,4,2,0,2,0,2,50
ZNGA,SMART,USD,4,2,0,2,0,2,50
GLW,SMART,USD,4,2,0,2,0,2,50
CDK,SMART,USD,4,2,0,2,0,2,50
CBOE,SMART,USD,4,2,0,2,0,2,50
EXPD,SMART,USD,4,2,0,2,0,2,50
CDAY,SMART,USD,4,2,0,2,0,2,50
HDB,SMART,USD,4,2,0,2,0,2,50
MSGS,SMART,USD,4,2,0,2,0,2,50
SON,SMART,USD,4,2,0,2,0,2,50
KLAC,SMART,USD,4,2,0,2,0,2,50
ASH,SMART,USD,4,2,0,2,0,2,50
EIX,SMART,USD,4,2,0,2,0,2,50
ASX,SMART,USD,4,2,0,2,0,2,50
XP,SMART,USD,4,2,0,2,0,2,50
VRT,SMART,USD,4,2,0,2,0,2,50
THG,SMART,USD,4,2,0,2,0,2,50
IMAB,SMART,USD,4,2,0,2,0,2,50
SDGR,SMART,USD,4,2,0,2,0,2,50
GFL,SMART,USD,4,2,0,2,0,2,50
MGNI,SMART,USD,4,2,0,2,0,2,50
U,SMART,USD,4,2,0,2,0,2,50
ZTS,SMART,USD,4,1,1,1,1,2,50
WSO,SMART,USD,4,1,1,1,1,2,50
TSCO,SMART,USD,4,1,1,1,1,2,50
NTR,SMART,USD,4,1,1,1,1,2,50
IPG,SMART,USD,4,1,1,1,1,2,50
TXN,SMART,USD,4,1,1,2,0,2,50
SBNY,SMART,USD,4,1,1,2,0,2,50
DG,SMART,USD,4,1,1,2,0,2,50
CHTR,SMART,USD,4,1,1,2,0,2,50
LOW,SMART,USD,4,1,1,2,0,2,50
MMS,SMART,USD,4,1,1,2,0,2,50
WAT,SMART,USD,4,1,1,2,0,2,50
BBU,SMART,USD,4,1,1,2,0,2,50
KDP,SMART,USD,4,1,1,2,0,2,50
DLTR,SMART,USD,4,1,1,2,0,2,50
LANC,SMART,USD,4,0,2,2,0,2,50
AWK,SMART,USD,2,1,0,0,1,1,50
FTS,SMART,USD,2,1,0,0,1,1,50
SJM,SMART,USD,2,1,0,0,1,1,50
ABT,SMART,USD,2,1,0,0,1,1,50
IWM,SMART,USD,2,1,0,1,0,1,50
FELE,SMART,USD,2,1,0,1,0,1,50
MNST,SMART,USD,2,1,0,1,0,1,50
MGEE,SMART,USD,2,1,0,1,0,1,50
YUMC,SMART,USD,2,1,0,1,0,1,50
BMY,SMART,USD,2,1,0,1,0,1,50
PGR,SMART,USD,2,1,0,1,0,1,50
LH,SMART,USD,2,1,0,1,0,1,50
LEG,SMART,USD,2,1,0,1,0,1,50
DHR,SMART,USD,2,1,0,1,0,1,50
EXLS,SMART,USD,2,1,0,1,0,1,50
MDU,SMART,USD,2,1,0,1,0,1,50
OGS,SMART,USD,2,1,0,1,0,1,50
MRK,SMART,USD,2,1,0,1,0,1,50
PEG,SMART,USD,2,1,0,1,0,1,50
CTVA,SMART,USD,2,1,0,1,0,1,50
RY,SMART,USD,2,1,0,1,0,1,50
NSC,SMART,USD,2,1,0,1,0,1,50
LNT,SMART,USD,2,1,0,1,0,1,50
IFS,SMART,USD,2,1,0,1,0,1,50
CVBF,SMART,USD,2,1,0,1,0,1,50
SAP,SMART,USD,2,1,0,1,0,1,50
FSKR,SMART,USD,2,1,0,1,0,1,50
CLVT,SMART,USD,2,1,0,1,0,1,50
OM,SMART,USD,2,1,0,1,0,1,50
CRSR,SMART,USD,2,1,0,1,0,1,50
CVAC,SMART,USD,2,1,0,1,0,1,50
GDRX,SMART,USD,2,1,0,1,0,1,50
STEP,SMART,USD,2,1,0,1,0,1,50
MNSO,SMART,USD,2,1,0,1,0,1,50
WISH,SMART,USD,2,1,0,1,0,1,50
SEER,SMART,USD,2,1,0,1,0,1,50
ICE,SMART,USD,2,0,1,0,1,1,50
WTS,SMART,USD,2,0,1,0,1,1,50
VZ,SMART,USD,2,0,1,1,0,1,50
TM,SMART,USD,2,0,1,1,0,1,50
OPK,SMART,USD,17,7,1,9,0,8,47.05882353
SKX,SMART,USD,15,6,1,4,4,7,46.66666667
SPR,SMART,USD,15,5,2,8,0,7,46.66666667
EDU,SMART,USD,13,6,0,6,1,6,46.15384615
FTI,SMART,USD,13,6,0,7,0,6,46.15384615
FUTU,SMART,USD,13,6,0,7,0,6,46.15384615
CNQ,SMART,USD,13,5,1,6,1,6,46.15384615
RYAAY,SMART,USD,13,5,1,7,0,6,46.15384615
TROX,SMART,USD,13,5,1,7,0,6,46.15384615
PHI,SMART,USD,13,2,4,6,1,6,46.15384615
KEY,SMART,USD,11,5,0,4,2,5,45.45454545
TER,SMART,USD,11,5,0,6,0,5,45.45454545
KRNT,SMART,USD,11,5,0,6,0,5,45.45454545
CREE,SMART,USD,11,5,0,6,0,5,45.45454545
SEAS,SMART,USD,11,4,1,4,2,5,45.45454545
SU,SMART,USD,11,4,1,6,0,5,45.45454545
LOGI,SMART,USD,11,4,1,6,0,5,45.45454545
ELP,SMART,USD,11,4,1,6,0,5,45.45454545
TPR,SMART,USD,11,3,2,6,0,5,45.45454545
FUN,SMART,USD,9,4,0,2,3,4,44.44444444
MDC,SMART,USD,9,4,0,3,2,4,44.44444444
AIG,SMART,USD,9,4,0,4,1,4,44.44444444
PRI,SMART,USD,9,4,0,4,1,4,44.44444444
GPI,SMART,USD,9,4,0,5,0,4,44.44444444
PEGA,SMART,USD,9,4,0,5,0,4,44.44444444
SNP,SMART,USD,9,3,1,4,1,4,44.44444444
FLS,SMART,USD,9,3,1,4,1,4,44.44444444
CNS,SMART,USD,9,3,1,4,1,4,44.44444444
LFC,SMART,USD,9,3,1,4,1,4,44.44444444
DIOD,SMART,USD,9,3,1,5,0,4,44.44444444
NUAN,SMART,USD,9,2,2,5,0,4,44.44444444
CLF,SMART,USD,16,6,1,9,0,7,43.75
ANGI,SMART,USD,14,6,0,8,0,6,42.85714286
FCX,SMART,USD,14,6,0,8,0,6,42.85714286
DVN,SMART,USD,14,6,0,8,0,6,42.85714286
CCU,SMART,USD,7,3,0,2,2,3,42.85714286
DFS,SMART,USD,7,3,0,2,2,3,42.85714286
URBN,SMART,USD,7,3,0,2,2,3,42.85714286
FICO,SMART,USD,7,3,0,3,1,3,42.85714286
GWRE,SMART,USD,7,3,0,3,1,3,42.85714286
ORI,SMART,USD,7,3,0,3,1,3,42.85714286
AZPN,SMART,USD,7,3,0,3,1,3,42.85714286
CRWD,SMART,USD,7,3,0,3,1,3,42.85714286
RDN,SMART,USD,7,3,0,4,0,3,42.85714286
EPAM,SMART,USD,7,3,0,4,0,3,42.85714286
SNV,SMART,USD,7,3,0,4,0,3,42.85714286
AEM,SMART,USD,7,3,0,4,0,3,42.85714286
SNDR,SMART,USD,7,3,0,4,0,3,42.85714286
ATUS,SMART,USD,7,3,0,4,0,3,42.85714286
MO,SMART,USD,7,3,0,4,0,3,42.85714286
LSPD,SMART,USD,7,3,0,4,0,3,42.85714286
LAZR,SMART,USD,7,3,0,4,0,3,42.85714286
ABEV,SMART,USD,7,2,1,1,3,3,42.85714286
BLK,SMART,USD,7,2,1,2,2,3,42.85714286
CSOD,SMART,USD,7,2,1,3,1,3,42.85714286
GRFS,SMART,USD,7,2,1,4,0,3,42.85714286
KWR,SMART,USD,7,2,1,4,0,3,42.85714286
GMED,SMART,USD,7,1,2,3,1,3,42.85714286
MAIN,SMART,USD,7,1,2,4,0,3,42.85714286
NVRO,SMART,USD,19,6,2,10,1,8,42.10526316
ZNH,SMART,USD,19,5,3,10,1,8,42.10526316
OLED,SMART,USD,12,5,0,6,1,5,41.66666667
CAKE,SMART,USD,12,5,0,6,1,5,41.66666667
NSTG,SMART,USD,12,4,1,7,0,5,41.66666667
JWN,SMART,USD,12,4,1,7,0,5,41.66666667
ALK,SMART,USD,12,3,2,5,2,5,41.66666667
VEDL,SMART,USD,17,6,1,10,0,7,41.17647059
MANH,SMART,USD,10,4,0,4,2,4,40
PAGS,SMART,USD,10,4,0,5,1,4,40
WWE,SMART,USD,10,4,0,6,0,4,40
SPSC,SMART,USD,10,3,1,4,2,4,40
TOL,SMART,USD,10,3,1,5,1,4,40
TEAM,SMART,USD,10,3,1,5,1,4,40
NFLX,SMART,USD,10,3,1,6,0,4,40
HLNE,SMART,USD,10,3,1,6,0,4,40
HRC,SMART,USD,5,2,0,2,1,2,40
WNS,SMART,USD,5,2,0,2,1,2,40
HMC,SMART,USD,5,2,0,2,1,2,40
ACA,SMART,USD,5,2,0,2,1,2,40
NOW,SMART,USD,5,2,0,3,0,2,40
INTC,SMART,USD,5,2,0,3,0,2,40
EWBC,SMART,USD,5,2,0,3,0,2,40
ENV,SMART,USD,5,2,0,3,0,2,40
DOV,SMART,USD,5,2,0,3,0,2,40
FRC,SMART,USD,5,2,0,3,0,2,40
TTC,SMART,USD,5,2,0,3,0,2,40
FBHS,SMART,USD,5,2,0,3,0,2,40
BIP,SMART,USD,5,2,0,3,0,2,40
CCEP,SMART,USD,5,1,1,2,1,2,40
CAJ,SMART,USD,5,1,1,2,1,2,40
WU,SMART,USD,5,1,1,2,1,2,40
DVA,SMART,USD,5,1,1,2,1,2,40
JNPR,SMART,USD,5,1,1,2,1,2,40
LHX,SMART,USD,5,1,1,3,0,2,40
CATY,SMART,USD,5,1,1,3,0,2,40
KT,SMART,USD,5,1,1,3,0,2,40
KNSL,SMART,USD,5,1,1,3,0,2,40
ATR,SMART,USD,5,1,1,3,0,2,40
PAYC,SMART,USD,5,1,1,3,0,2,40
DHI,SMART,USD,5,1,1,3,0,2,40
NGG,SMART,USD,5,1,1,3,0,2,40
NFG,SMART,USD,5,1,1,3,0,2,40
LBTYK,SMART,USD,5,1,1,3,0,2,40
ADM,SMART,USD,5,1,1,3,0,2,40
JNJ,SMART,USD,5,0,2,3,0,2,40
SSL,SMART,USD,18,6,1,11,0,7,38.88888889
WES,SMART,USD,13,5,0,8,0,5,38.46153846
VICR,SMART,USD,13,5,0,8,0,5,38.46153846
ALGN,SMART,USD,13,5,0,8,0,5,38.46153846
PDCO,SMART,USD,8,3,0,3,2,3,37.5
GS,SMART,USD,8,3,0,4,1,3,37.5
CCK,SMART,USD,8,3,0,4,1,3,37.5
ACIW,SMART,USD,8,3,0,4,1,3,37.5
CVET,SMART,USD,8,3,0,4,1,3,37.5
BAP,SMART,USD,8,3,0,5,0,3,37.5
SAIL,SMART,USD,8,3,0,5,0,3,37.5
CBRL,SMART,USD,8,3,0,5,0,3,37.5
VOD,SMART,USD,8,2,1,4,1,3,37.5
DE,SMART,USD,8,2,1,5,0,3,37.5
LCII,SMART,USD,8,2,1,5,0,3,37.5
VALE,SMART,USD,8,2,1,5,0,3,37.5
PLXS,SMART,USD,8,2,1,5,0,3,37.5
KTOS,SMART,USD,11,4,0,6,1,4,36.36363636
HTHT,SMART,USD,11,4,0,7,0,4,36.36363636
STLD,SMART,USD,11,3,1,5,2,4,36.36363636
WBA,SMART,USD,11,3,1,6,1,4,36.36363636
NAV,SMART,USD,11,3,1,7,0,4,36.36363636
AX,SMART,USD,15,5,0,9,1,5,33.33333333
DISCK,SMART,USD,12,4,0,7,1,4,33.33333333
LPL,SMART,USD,12,4,0,8,0,4,33.33333333
STLA,SMART,USD,12,2,2,7,1,4,33.33333333
FLT,SMART,USD,9,3,0,5,1,3,33.33333333
TAL,SMART,USD,9,3,0,6,0,3,33.33333333
FIX,SMART,USD,9,1,2,3,3,3,33.33333333
NOMD,SMART,USD,6,2,0,3,1,2,33.33333333
ZTO,SMART,USD,6,2,0,4,0,2,33.33333333
MOR,SMART,USD,6,2,0,4,0,2,33.33333333
STL,SMART,USD,6,2,0,4,0,2,33.33333333
AVTR,SMART,USD,6,2,0,4,0,2,33.33333333
MP,SMART,USD,6,2,0,4,0,2,33.33333333
CHKP,SMART,USD,6,1,1,1,3,2,33.33333333
CERN,SMART,USD,6,1,1,3,1,2,33.33333333
NLSN,SMART,USD,6,1,1,4,0,2,33.33333333
MFC,SMART,USD,3,1,0,0,2,1,33.33333333
NEM,SMART,USD,3,1,0,0,2,1,33.33333333
CNO,SMART,USD,3,1,0,1,1,1,33.33333333
SHOO,SMART,USD,3,1,0,1,1,1,33.33333333
BIO,SMART,USD,3,1,0,1,1,1,33.33333333
FNF,SMART,USD,3,1,0,1,1,1,33.33333333
CAG,SMART,USD,3,1,0,1,1,1,33.33333333
AVY,SMART,USD,3,1,0,1,1,1,33.33333333
DOX,SMART,USD,3,1,0,2,0,1,33.33333333
JPM,SMART,USD,3,1,0,2,0,1,33.33333333
AWI,SMART,USD,3,1,0,2,0,1,33.33333333
AVGO,SMART,USD,3,1,0,2,0,1,33.33333333
GGG,SMART,USD,3,1,0,2,0,1,33.33333333
ROP,SMART,USD,3,1,0,2,0,1,33.33333333
EA,SMART,USD,3,1,0,2,0,1,33.33333333
GPK,SMART,USD,3,1,0,2,0,1,33.33333333
IFF,SMART,USD,3,1,0,2,0,1,33.33333333
WORK,SMART,USD,3,1,0,2,0,1,33.33333333
KR,SMART,USD,3,1,0,2,0,1,33.33333333
BLL,SMART,USD,3,1,0,2,0,1,33.33333333
HON,SMART,USD,3,1,0,2,0,1,33.33333333
CDW,SMART,USD,3,1,0,2,0,1,33.33333333
CNI,SMART,USD,3,1,0,2,0,1,33.33333333
KC,SMART,USD,3,1,0,2,0,1,33.33333333
APG,SMART,USD,3,1,0,2,0,1,33.33333333
PSFE,SMART,USD,3,1,0,2,0,1,33.33333333
AI,SMART,USD,3,1,0,2,0,1,33.33333333
ACN,SMART,USD,3,0,1,2,0,1,33.33333333
CBU,SMART,USD,3,0,1,2,0,1,33.33333333
BPOP,SMART,USD,3,0,1,2,0,1,33.33333333
MDLZ,SMART,USD,3,0,1,2,0,1,33.33333333
TU,SMART,USD,3,0,1,2,0,1,33.33333333
RCI,SMART,USD,3,0,1,2,0,1,33.33333333
IRBT,SMART,USD,13,4,0,8,1,4,30.76923077
TTD,SMART,USD,10,3,0,7,0,3,30
SI,SMART,USD,10,3,0,7,0,3,30
TTEC,SMART,USD,7,2,0,4,1,2,28.57142857
EL,SMART,USD,7,2,0,4,1,2,28.57142857
DD,SMART,USD,7,2,0,4,1,2,28.57142857
SWKS,SMART,USD,7,2,0,5,0,2,28.57142857
ALB,SMART,USD,7,2,0,5,0,2,28.57142857
FTCH,SMART,USD,7,2,0,5,0,2,28.57142857
KFY,SMART,USD,7,1,1,5,0,2,28.57142857
PHG,SMART,USD,7,1,1,5,0,2,28.57142857
STM,SMART,USD,11,2,1,8,0,3,27.27272727
ISRG,SMART,USD,8,2,0,4,2,2,25
DAR,SMART,USD,8,2,0,5,1,2,25
VRNS,SMART,USD,8,2,0,5,1,2,25
BG,SMART,USD,8,2,0,5,1,2,25
BHP,SMART,USD,8,1,1,5,1,2,25
SEE,SMART,USD,4,1,0,1,2,1,25
STT,SMART,USD,4,1,0,2,1,1,25
SAIC,SMART,USD,4,1,0,2,1,1,25
ZBH,SMART,USD,4,1,0,2,1,1,25
SSB,SMART,USD,4,1,0,3,0,1,25
KMB,SMART,USD,4,1,0,3,0,1,25
UMBF,SMART,USD,4,1,0,3,0,1,25
ONTO,SMART,USD,4,1,0,3,0,1,25
AQN,SMART,USD,4,1,0,3,0,1,25
CM,SMART,USD,4,1,0,3,0,1,25
NTCO,SMART,USD,4,1,0,3,0,1,25
NEU,SMART,USD,4,0,1,1,2,1,25
LPRO,SMART,USD,4,0,1,2,1,1,25
IHG,SMART,USD,4,0,1,3,0,1,25
NTRS,SMART,USD,4,0,1,3,0,1,25
LBTYA,SMART,USD,4,0,1,3,0,1,25
RE,SMART,USD,4,0,1,3,0,1,25
WCN,SMART,USD,4,0,1,3,0,1,25
MT,SMART,USD,13,3,0,9,1,3,23.07692308
TLK,SMART,USD,9,1,1,6,1,2,22.22222222
LLY,SMART,USD,5,1,0,2,2,1,20
BNS,SMART,USD,5,1,0,3,1,1,20
FMX,SMART,USD,5,1,0,3,1,1,20
CENTA,SMART,USD,5,1,0,3,1,1,20
XYL,SMART,USD,5,1,0,3,1,1,20
GLL,SMART,USD,5,1,0,4,0,1,20
RIO,SMART,USD,5,0,1,4,0,1,20
JHX,SMART,USD,12,1,1,9,1,2,16.66666667
ENB,SMART,USD,6,1,0,2,3,1,16.66666667
CPRT,SMART,USD,6,1,0,4,1,1,16.66666667
PKX,SMART,USD,6,1,0,5,0,1,16.66666667
ADBE,SMART,USD,6,1,0,5,0,1,16.66666667
TFSL,SMART,USD,7,1,0,6,0,1,14.28571429
ESLT,SMART,USD,7,0,1,6,0,1,14.28571429
PANW,SMART,USD,8,1,0,5,2,1,12.5
SPLK,SMART,USD,8,1,0,7,0,1,12.5
GOLD,SMART,USD,8,1,0,7,0,1,12.5
BBL,SMART,USD,5,0,0,5,0,0,0
BABA,SMART,USD,5,0,0,5,0,0,0
COG,SMART,USD,4,0,0,3,1,0,0
ALC,SMART,USD,3,0,0,3,0,0,0
API,SMART,USD,3,0,0,3,0,0,0
LBRDK,SMART,USD,2,0,0,1,1,0,0
CSX,SMART,USD,2,0,0,1,1,0,0
WM,SMART,USD,2,0,0,1,1,0,0
TSM,SMART,USD,2,0,0,2,0,0,0
TKC,SMART,USD,2,0,0,2,0,0,0
ATO,SMART,USD,2,0,0,2,0,0,0
OZON,SMART,USD,2,0,0,2,0,0,0
POSH,SMART,USD,2,0,0,2,0,0,0
FLO,SMART,USD,1,0,0,0,1,0,0
ESE,SMART,USD,1,0,0,0,1,0,0
CL,SMART,USD,1,0,0,0,1,0,0
VRSN,SMART,USD,1,0,0,1,0,0,0
NEOG,SMART,USD,1,0,0,1,0,0,0
PEP,SMART,USD,1,0,0,1,0,0,0
BAX,SMART,USD,1,0,0,1,0,0,0
FIBK,SMART,USD,1,0,0,1,0,0,0
OTIS,SMART,USD,1,0,0,1,0,0,0
BR,SMART,USD,1,0,0,1,0,0,0
WTM,SMART,USD,1,0,0,1,0,0,0
SNY,SMART,USD,1,0,0,1,0,0,0
SEB,SMART,USD,1,0,0,1,0,0,0
DNB,SMART,USD,1,0,0,1,0,0,0
YSG,SMART,USD,1,0,0,1,0,0,0
IAC,SMART,USD,1,0,0,1,0,0,0
FROG,SMART,USD,1,0,0,1,0,0,0
ARRY,SMART,USD,1,0,0,1,0,0,0
ASO,SMART,USD,1,0,0,1,0,0,0
PM,SMART,USD,0,0,0,0,0,0,0
GE,SMART,USD,0,0,0,0,0,0,0
CPNG,SMART,USD,0,0,0,0,0,0,0
COIN,SMART,USD,0,0,0,0,0,0,0
RBLX,SMART,USD,0,0,0,0,0,0,0
XEL,SMART,USD,0,0,0,0,0,0,0
PATH,SMART,USD,0,0,0,0,0,0,0
CHT,SMART,USD,0,0,0,0,0,0,0
LU,SMART,USD,0,0,0,0,0,0,0
FERG,SMART,USD,0,0,0,0,0,0,0
APP,SMART,USD,0,0,0,0,0,0,0
WMG,SMART,USD,0,0,0,0,0,0,0
UWMC,SMART,USD,0,0,0,0,0,0,0
AGL,SMART,USD,0,0,0,0,0,0,0
PLTK,SMART,USD,0,0,0,0,0,0,0
ZI,SMART,USD,0,0,0,0,0,0,0
OLK,SMART,USD,0,0,0,0,0,0,0
TSP,SMART,USD,0,0,0,0,0,0,0
TUYA,SMART,USD,0,0,0,0,0,0,0
TIXT,SMART,USD,0,0,0,0,0,0,0
CSAN,SMART,USD,0,0,0,0,0,0,0
AZEK,SMART,USD,0,0,0,0,0,0,0
SHC,SMART,USD,0,0,0,0,0,0,0
COMP,SMART,USD,0,0,0,0,0,0,0
BMBL,SMART,USD,0,0,0,0,0,0,0
SGFY,SMART,USD,0,0,0,0,0,0,0
COUR,SMART,USD,0,0,0,0,0,0,0
ORCC,SMART,USD,0,0,0,0,0,0,0
RXRX,SMART,USD,0,0,0,0,0,0,0
DSEY,SMART,USD,0,0,0,0,0,0,0
DCT,SMART,USD,0,0,0,0,0,0,0
DV,SMART,USD,0,0,0,0,0,0,0
SHLS,SMART,USD,0,0,0,0,0,0,0
VNT,SMART,USD,0,0,0,0,0,0,0
ALGM,SMART,USD,0,0,0,0,0,0,0
HAYW,SMART,USD,0,0,0,0,0,0,0
OCDX,SMART,USD,0,0,0,0,0,0,0
DOCN,SMART,USD,0,0,0,0,0,0,0
ULCC,SMART,USD,0,0,0,0,0,0,0
CHK,SMART,USD,0,0,0,0,0,0,0
ZY,SMART,USD,0,0,0,0,0,0,0
ATC,SMART,USD,0,0,0,0,0,0,0
OLO,SMART,USD,0,0,0,0,0,0,0
BHFAN,SMART,USD,0,0,0,0,0,0,0
ALKT,SMART,USD,0,0,0,0,0,0,0
EBC,SMART,USD,0,0,0,0,0,0,0
ASAI,SMART,USD,0,0,0,0,0,0,0
KNBE,SMART,USD,0,0,0,0,0,0,0
PRVA,SMART,USD,0,0,0,0,0,0,0
MRVI,SMART,USD,0,0,0,0,0,0,0
INNV,SMART,USD,0,0,0,0,0,0,0
SWIM,SMART,USD,0,0,0,0,0,0,0
RLAY,SMART,USD,0,0,0,0,0,0,0
BNR,SMART,USD,0,0,0,0,0,0,0